'89 Dennou Kyuusei Uranai (Japan)=신궁관 89 컴퓨터 구성점
10-Yard Fight (Japan) (Rev 1)=10 야드 파이트 (일본판)(개정판 1)
10-Yard Fight (Japan)=10 야드 파이트 (일본판)
10-Yard Fight (USA, Europe)=10 야드 파이트
100 Man Dollar Kid - Maboroshi no Teiou Hen (Japan)=100만 달러 소년 - 환상의 제왕편 (일본판)
110 in 1 (Asia) (En) (Unl) (Pirate)=110 합팩
1942 (Japan, USA)=1942
1943 - The Battle of Midway (Japan) (Beta)=1943 - 미드웨이 해전 (일본판)(베타)
1943 - The Battle of Midway (USA)=1943 - 미드웨이 해전
1943 - The Battle of Valhalla (Japan)=1943 - 발할라 해전 (일본판)
1991 Du Ma Racing (Asia) (Ja) (Idea-Tek) (Unl)=1991 DUMA 레이싱
1991 Du Ma Racing (Asia) (Ja) (Micro Genius) (Unl)=1991 DUMA 레이싱 (아시아판)(일본어)(해적판)
1999 - Hore, Mitakotoka! Seikimatsu (Japan)=1999 이봐 보았는가! 세기말
2010 Street Fighter (Japan)=스트리트 파이터 2010 (일본판)
3 in 1 Supergun (Asia) (Ja) (Unl)=3 in 1 슈퍼건
3-D WorldRunner (USA)=3D 배틀스 오브 월드 런너
3D Block (Asia) (Ja) (Hwang Shinwei) (Unl)=3D 블럭
3D Block (Asia) (Ja) (RCM Group) (Unl)=3D 블럭 (아시아판)(일본어)(RCM 그룹)(해적판)
4 Nin Uchi Mahjong (Japan) (Rev 1)=신 4인 마작 - 역만천국
4 Nin Uchi Mahjong (Japan)=신 4인 마작 - 역만천국 (일본판)
720 Degrees (USA)=720 도
8 Eyes (Japan)=8 아이즈 (일본판)
8 Eyes (USA)=8 아이즈
A Ressha de Ikou (Japan)=A 열차로 가자!
Aa Yakyuu Jinsei Icchokusen (Japan)=오호! 야구 인생 일직선
Abadox (Japan)=아바독스 (일본판)
Abadox - The Deadly Inner War (USA)=아바독스 - 지옥의 이너워즈
Abarenbou Tengu (Japan)=망나니 텐구 (일본판)
Aces - Iron Eagle III (Japan)=에이스 - 강철독수리3 (일본판)
Action 52 (USA) (Rev A) (Unl)=액션 52
Action 52 (USA) (Unl)=액션 52 (해적판)
Action in New York (Europe)=뉴욕 속의 액션
Adam & Eve (Asia) (En) (Mega Soft) (Unl)=아담과 이브
Adan y Eva (Spain) (Gluk Video) (Unl)=아담과 이브 (스페인판)(글럭 비디오)(해적판)
Addams Family, The (Europe) (En,Fr,De)=아담스 패밀리
Addams Family, The (USA)=아담스 패밀리
Addams Family, The - Pugsley's Scavenger Hunt (Europe) (Beta)=아담스 패밀리 - 퍼그슬리의 스캐빈져 사냥 (유럽판)(베타)
Addams Family, The - Pugsley's Scavenger Hunt (Europe)=아담스 패밀리 - 퍼그슬리의 스캐빈져 사냥
Addams Family, The - Pugsley's Scavenger Hunt (USA)=아담스 패밀리 - 퍼그슬리의 스캐빈져 사냥
Addams Family, The - Uncle Fester's Quest (USA) (Beta)=아담스 패밀리 - 페스터 삼촌의 모험 (베타)
Advanced Dungeons & Dragons - Dragons of Flame (Japan)=AD&D 드래곤 오브 프레임
Advanced Dungeons & Dragons - DragonStrike (USA)=AD&D 드래곤 스트라이크
Advanced Dungeons & Dragons - Heroes of the Lance (Japan)=AD&D 히어로즈 오브 랜스 (일본판)
Advanced Dungeons & Dragons - Heroes of the Lance (USA) (Beta)=AD&D 히어로즈 오브 랜스 (베타)
Advanced Dungeons & Dragons - Heroes of the Lance (USA)=AD&D 히어로즈 오브 랜스
Advanced Dungeons & Dragons - Hillsfar (Japan)=AD&D 힐스파 (일본판)
Advanced Dungeons & Dragons - Hillsfar (USA)=AD&D 힐스파
Advanced Dungeons & Dragons - Pool of Radiance (Japan)=AD&D 풀 오브 래디언스 (일본판)
Advanced Dungeons & Dragons - Pool of Radiance (USA)=AD&D 풀 오브 래디언스
Adventure Island (USA)=고교 명인의 모험도
Adventure Island 3 (USA)=고교 명인의 모험도 3
Adventure Island Classic (Europe)=고교 명인의 모험도 클래식
Adventure Island II (USA) (Beta)=고교 명인의 모험도 2 (베타)
Adventure Island II (USA)=고교 명인의 모험도 2
Adventure Island III (Europe) (Proto)=고교 명인의 모험도 3 (유럽판)(시험판)
Adventure Island Part II, The (Europe)=고교 명인의 모험도 2
Adventures in the Magic Kingdom (Europe)=어드벤처 인 더 매직 킹덤
Adventures in the Magic Kingdom (USA) (Beta 1)=어드벤처 인 더 매직 킹덤 (배타 1)
Adventures in the Magic Kingdom (USA) (Beta 2)=어드벤처 인 더 매직 킹덤 (베타 2)
Adventures in the Magic Kingdom (USA)=어드벤처 인 더 매직 킹덤
Adventures of Bayou Billy, The (Europe)=배이유 빌리의 모험
Adventures of Bayou Billy, The (USA) (Virtual Console)=배이유 빌리의 모험 (버추얼 콘솔)
Adventures of Bayou Billy, The (USA)=배이유 빌리의 모험
Adventures of Dino Riki (USA)=디노 리키의 모험
Adventures of Dr. Franken, The (USA) (Proto)=닥터 프랑켄의 모험
Adventures of Gilligan's Island, The (USA)=길릭간스 아일랜드
Adventures of Lolo (Europe) (Virtual Console)=로로의 모험 (유럽판)(버추얼 콘솔)
Adventures of Lolo (Europe)=로로의 모험
Adventures of Lolo (Japan)=로로의 모험 (일본판)
Adventures of Lolo (USA) (Virtual Console)=로로의 모험 (버추얼 콘솔)
Adventures of Lolo (USA)=로로의 모험
Adventures of Lolo 2 (Europe) (Virtual Console)=로로의 모험 2 (유럽판)(버추얼 콘솔)
Adventures of Lolo 2 (Europe)=로로의 모험 2
Adventures of Lolo 2 (USA) (Virtual Console)=로로의 모험 2 (버추얼 콘솔)
Adventures of Lolo 2 (USA)=로로의 모험 2
Adventures of Lolo 3 (Europe)=로로의 모험 3
Adventures of Lolo 3 (USA)=로로의 모험 3
Adventures of Lolo II (Japan)=로로의 모험 2 (일본판)
Adventures of Rad Gravity, The (Europe)=라드 그래비디의 모험
Adventures of Rad Gravity, The (USA)=라드 그래비디의 모험
Adventures of Rocky and Bullwinkle and Friends, The (USA)=록키와 불윙클 그리고 친구들의 모험
Adventures of Tom Sawyer (USA)=톰 소요의 모험
After Burner (Japan)=애프터 버너
After Burner (USA) (Unl)=애프터 버너 (해적판)
Ai Sensei no Oshiete - Watashi no Hoshi (Japan)=사랑 선생의 가르쳐줘 - 나의 별
Aigina no Yogen - Balubalouk no Densetsu Yori (Japan)=아이기나의 예언- 발루발로크의 전설에서
Air Fortress (Europe)=에어 포트리스
Air Fortress (Japan)=에어 포트리스 (일본판)
Air Fortress (USA)=에어 포트리스
Airball (USA) (Proto 1)=에어볼 (시험판 1)
Airball (USA) (Proto 2)=에어볼
Airwolf (Europe) (Acclaim)=에어울프
Airwolf (Japan) (Kyugo)=에어울프
Airwolf (USA) (Acclaim)=에어울프 (액클레임)
Akagawa Jirou no Yuurei Ressha (Japan)=아카가와 지로의 유령열차
Akira (Japan)=아키라
Akuma no Shoutaijou (Japan)=악마의 초대장 (일본판)
Akuma-kun - Makai no Wana (Japan)=악마군 - 마계의 덫
Akumajou Densetsu (Japan) (Castlevania Anniversary Collection)=악마성 전설 (일본판)(악마성 기념판 컬렉션)
Akumajou Densetsu (Japan) (Virtual Console)=악마성 전설 (일본판)(버추얼 콘솔)
Akumajou Densetsu (Japan)=악마성 전설 (일본판)
Akumajou Dracula (Japan) (Castlevania Anniversary Collection)=악마성 드라큘라 (일본판)(악마성 기념판 컬렉션)
Akumajou Dracula (Japan)=악마성 드라큘라 (일본판)
Akumajou Special - Boku Dracula-kun (Japan) (Castlevania Anniversary Collection)=악마성 스페셜 - 나는야 드라큘라군 (일본판)(악마성 기념판 컬렉션)
Akumajou Special - Boku Dracula-kun (Japan)=악마성 스페셜 - 나는야 드라큘라군
Al Unser Jr. Turbo Racing (USA)=알 언서 주니어 터보 레이싱
Aladdin (Europe)=알라딘
Alex DeMeo's Race America (USA)=레이스 아메리카
Alfombra Magica, La (Spain) (Gluk Video) (Unl)=마법 양탄자 (스페인판)(글럭 비디오)(해적판)
Alfombra Magica, La (Spain) (Rev 1) (Gluk Video) (Unl)=마법 양탄자
Alfred Chicken (Europe)=알프레드 치킨
Alfred Chicken (USA)=알프레드 치킨
Alien 3 (Europe)=에일리언 3
Alien 3 (USA)=에일리언 3
Alien Syndrome (Japan)=에일리언 신드롬
Alien Syndrome (USA) (Unl)=에일리언 신드롬 (해적판)
All-Pro Basketball (USA)=올프로 베스킷볼
Alpha Mission (Europe)=알파 미션
Alpha Mission (USA)=알파 미션
Amagon (USA)=아마곤
America Daitouryou Senkyo (Japan)=미국 대통령 선거
America Oudan Ultra Quiz - Shijou Saidai no Tatakai (Japan) (Rev 1)=미국 횡단 울트라 퀴즈 - 사상 최대의 싸움
America Oudan Ultra Quiz - Shijou Saidai no Tatakai (Japan)=미국 횡단 울트라 퀴즈 - 사상 최대의 싸움 (일본판)
American Dream (Japan)=아메리칸 드림
American Football - Touchdown Fever (Japan)=미식 축구 - 터치다운 피버 (일본판)
American Gladiators (USA)=아메리칸 글라디에이터
Ankoku Shinwa - Yamato Takeru Densetsu (Japan)=암흑 신화 - 야마토 타케루 전설
Anticipation (Europe)=안티시페이션
Anticipation (USA)=안티시페이션
Aoki Ookami to Shiroki Mejika - Genchou Hishi (Japan)=원조비사 - 푸른 늑대와 흰 암사슴
Aoki Ookami to Shiroki Mejika - Genghis Khan (Japan)=징기스칸 - 푸른 늑대와 흰 암사슴 (일본판)
Arabian Dream Scheherazade (Japan)=아라비안 드림 세라자드 (일본판)
Arcadia VI (USA) (Proto)=아르카디아 6
Arch Rivals - A Basketbrawl! (Europe)=아치 라이벌 - 배스킷볼
Arch Rivals - A Basketbrawl! (USA)=아치 라이벌 - 배스킷볼
Archon (USA)=아콘
Arctic (Japan)=아크틱
Arctic Adventure - Penguin & Seal (Australia) (Unl)=북극 탐험 - 펭귄과 물개
Argos no Senshi - Hachamecha Daishingeki (Japan)=아르고스의 전사 (일본판)
Argus (Japan)=아르고스
Arkanoid (Japan)=알카노이드 (일본판)
Arkanoid (USA)=알카노이드
Arkanoid II (Japan) (Beta)=알카노이드 2 (일본판)(베타)
Arkanoid II (Japan)=알카노이드 2
Arkista's Ring (USA)=아키스타의 반지
Armadillo (Japan)=아르마딜로
Artelius (Japan)=아텔리우스
Asmik-kun Land (Japan)=아스믹군 랜드
ASO - Armored Scrum Object (Japan) (En) (Sample)=ASO - 아머드 스크럼 오브젝트 (일본판)(영어)(샘플)
ASO - Armored Scrum Object (Japan) (En)=ASO - 아머드 스크럼 오브젝트 (일본판)(영어)
Asterix (Europe) (En,Fr,De,Es,It)=아스테릭스
Astro Fang - Super Machine (Japan)=아스트 팡 - 슈퍼머신
Astro Robo Sasa (Japan)=아스트로 로보 사사
Astyanax (Europe)=아스티아낙스
Astyanax (USA) (Beta)=아스티아낙스 (베타)
Astyanax (USA)=아스티아낙스
Athena (Japan)=아테나 (일본판)
Athena (USA)=아테나
Athletic World (Europe)=어슬레틱 월드
Athletic World (USA)=어슬레틱 월드
Atlantis no Nazo (Japan) (Beta)=아틀란티스의 수수께기 (일본판)(베타)
Atlantis no Nazo (Japan) (Virtual Console, Switch Online)=아틀란티스의 수수께기 (일본판)
Atlantis no Nazo (Japan)=아틀란티스의 수수께기
Attack Animal Gakuen (Japan)=공격 동물학원
Attack of the Killer Tomatoes (Europe)=토마토 공격대
Attack of the Killer Tomatoes (USA)=토마토 공격대
Aussie Rules Footy (Australia)=어시 룰스 푸티
Auto-Upturn (Asia) (Ja) (PAL) (Unl)=오토 업턴
AV Hanafuda Club (Japan) (Unl)=AV 화투클럽
AV Kyuukyoku Mahjong 2 (Asia) (Ja) (Ge De) (Unl)=AV 궁극마작 2 (아시아판)(일본어)(해적판)
AV Kyuukyoku Mahjong 2 (Asia) (Ja) (Ka Sheng) (Unl)=AV 궁극마작 2
AV Mahjong Club (Asia) (Ja) (Unl)=AV 마작클럽 (아시아판)(일본어)(해적판)
AV Mahjong Club (Japan) (Unl)=AV 마작클럽
AV Mei Shao Nv Zhan Shi (Asia) (Unl)=AV 미소녀 전사
AV Pachi-Slot (Asia) (Ja) (Unl)=AV 파치-슬롯 (아시아판)(일본어)(해적판)
AV Pachi-Slot (Japan) (Unl)=AV 파치-슬롯
AV Poker (Japan) (Unl)=AV 포커 (일본판)(해적판)
AV Soccer (Japan) (Unl)=AV 사커 (일본판)(해적판)
AV Super Real Pachinko (Japan) (Unl)=AV 슈퍼 리얼 파칭코
B-Wings (Japan)=비-윙
Babel no Tou (Japan) (Namcot Collection)=바벨의 탑 (일본판)
Babel no Tou (Japan)=바벨의 탑
Baby Boomer (Korea) (Unl)=베이비 부머 (한국판)(해적판)
Baby Boomer (USA) (Unl)=베이비 부머
Back to the Future (USA)=백 투 더 퓨쳐
Back to the Future Part II & III (USA)=백 투 더 퓨쳐 2&3
Bad Dudes (USA)=나쁜 친구들 - 드래곤 닌자
Bad Dudes vs. Dragon Ninja (Europe)=나쁜 친구들 대 드래곤 닌자
Bad News Baseball (USA)=배드 뉴스 베이스볼
Bad Street Brawler (USA)=뒷골목 싸움꾼
Baken Hisshou Gaku - Gate In (Japan)=경마 필승 학습 - 게이트 인
Bakushou! Star Monomane Shitennou (Japan)=폭소! 스타 흉내 사천왕
Bakushou!! Ai no Gekijou (Japan)=폭소! 사랑의 극장
Bakushou!! Jinsei Gekijou (Japan)=폭소!! 인생극장
Bakushou!! Jinsei Gekijou 2 (Japan)=폭소!! 인생극장 2
Bakushou!! Jinsei Gekijou 3 (Japan)=폭소!! 인생극장 3
Ballblazer (Japan)=볼블레이져
Balloon Fight (Europe) (Virtual Console)=벌룬 파이트 (유럽판)(버추얼 콘솔)
Balloon Fight (Europe)=벌룬 파이트
Balloon Fight (Japan) (En) (GameCube Edition)=벌룬 파이트 (일본판)(영어)(게임큐브 버전)
Balloon Fight (Japan) (En)=벌룬 파이트 (일본판)(영어)
Balloon Fight (USA)=벌룬 파이트
Baltron (Japan) (Beta)=발트론 (일본판)(베타)
Baltron (Japan)=발트론
Banana (Japan) (Beta) (1986-06-30)=바나나 (일본판)(베타)(1986-06-30)
Banana (Japan) (Beta) (Earlier)=바나나 (일본판)(베타)(초기판)
Banana (Japan)=바나나
Banana Prince (Germany)=바나나 왕자의 대모험 (독일판)
Bananan Ouji no Daibouken (Japan)=바나나 왕자의 대모험
Bandai Golf - Challenge Pebble Beach (USA)=반다이 골프 - 챌린지 페블 비치
Bandit Kings of Ancient China (USA)=수호전
Bao Xiao San Guo (Asia) (Unl)=폭소삼국
Barbie (Europe)=바비
Barbie (USA) (Rev 1)=바비 (개정판 1)
Barbie (USA)=바비
Barcode World (Japan)=바코드 월드
Bard's Tale II, The - The Destiny Knight (Japan)=바즈테일 2 - 운명의 기사
Bard's Tale, The (Japan) (Sample)=바즈테일 (일본판)(샘플)
Bard's Tale, The (Japan)=바즈테일 (일본판)
Bard's Tale, The (USA)=바즈테일
Bard's Tale, The - Tales of the Unknown (USA) (Beta 1)=바즈테일 (배타 1)
Bard's Tale, The - Tales of the Unknown (USA) (Beta 2)=바즈테일 (베타 2)
Barker Bill's Trick Shooting (Europe)=바커 빌의 트릭 슈팅
Barker Bill's Trick Shooting (USA)=바커 빌의 트릭 슈팅
Baseball (Japan) (En) (GameCube Edition)=베이스볼 (일본판)(영어)(게임큐브 버전)
Baseball (Japan) (En)=베이스볼 (일본판)(영어)
Baseball (USA, Europe) (GameCube Edition)=베이스볼 (미국,유럽판)(게임큐브 버전)
Baseball (USA, Europe)=베이스볼
Baseball Fighter (Japan)=베이스볼 파이터
Baseball Simulator 1.000 (USA) (Virtual Console)=야구 시뮬레이터 1.000 (버추얼 콘솔)
Baseball Simulator 1.000 (USA)=야구 시뮬레이터 1.000
Baseball Star - Mezase Sankanou!! (Japan)=베이스볼 스타 - 노려라 삼관왕 (일본판)
Baseball Stars (USA)=베이스볼 스타즈
Baseball Stars II (USA)=베이스볼 스타즈 2
Bases Loaded (USA) (Rev 1)=만루 (개정판 1)
Bases Loaded (USA) (Rev 2)=만루
Bases Loaded (USA)=만루
Bases Loaded 3 (USA)=만루 3
Bases Loaded 4 (USA)=만루 4
Bases Loaded II - Second Season (USA)=만루 2
Bashi Bazook - Morphoid Masher (USA) (Proto) (1989-05-29)=바이오 전사 단 - 인크리서의 전투 (시험판)
Batman (Japan)=배트맨 (일본판)
Batman - Return of the Joker (Europe)=배트맨 - 조커의 귀환
Batman - Return of the Joker (USA) (Beta)=배트맨 - 조커의 귀환 (베타)
Batman - Return of the Joker (USA)=배트맨 - 조커의 귀환
Batman - The Video Game (Europe)=배트맨 - 비디오 게임
Batman - The Video Game (USA) (Beta 1)=배트맨 - 비디오 게임 (배타 1)
Batman - The Video Game (USA) (Beta 2)=배트맨 - 비디오 게임 (베타 2)
Batman - The Video Game (USA)=배트맨 - 비디오 게임
Batman Returns (Europe) (Beta)=배트맨 리턴즈 (유럽판)(베타)
Batman Returns (Europe)=배트맨 리턴즈
Batman Returns (USA)=배트맨 리턴즈
Batsu & Terry - Makyou no Tetsujin Race (Japan)=바츠 & 테리 - 마경의 철인 레이스
Battle Baseball (Japan)=배틀 베이스볼
Battle Chess (USA)=배틀 체스
Battle Fleet (Japan)=배틀 플릿
Battle Formula (Japan)=배틀 포뮬러 (일본판)
Battle of Olympus, The (Europe)=올림푸스의 전투
Battle of Olympus, The (USA)=올림푸스의 전투
Battle Stadium - Senbatsu Pro Yakyuu (Japan)=배틀 스타디움 - 선발 프로야구
Battle Storm (Japan)=배틀 스톰
BattleCity (Japan)=배틀 시티
BattleCity (World) (Ja) (Namcot Collection, Namco Museum Archives Vol 2)=배틀 시티 (세계판)(일본어)
Battleship (Europe) (En,Fr,De,Es)=배틀쉽
Battleship (USA)=배틀쉽
Battletoads (Europe)=배틀토드
Battletoads (Japan)=배틀토드 (일본판)
Battletoads (USA)=배틀토드
Battletoads-Double Dragon (Europe)=배틀토드 - 더블드래곤
Battletoads-Double Dragon (USA)=배틀토드 - 더블드래곤
BB Car (Asia) (En) (Unl)=방구차
Be-Bop-Highschool - Koukousei Gokuraku Densetsu (Japan)=비밥 하이스쿨 - 고교생 극락전설
Beauty and the Beast (Europe)=미녀와 야수
Bee 52 (USA) (Unl)=꿀벌 52번
Beetlejuice (USA)=비틀쥬스
Best Keiba - Derby Stallion (Japan) (Rev 1)=베스트 경마 - 더비 스탈리온
Best Keiba - Derby Stallion (Japan)=베스트 경마 - 더비 스탈리온 (일본판)
Best of the Best - Championship Karate (Europe)=베스트 오브 더 베스트 - 챔피온십 가라테
Best of the Best - Championship Karate (USA)=베스트 오브 더 베스트 - 챔피온십 가라테
Best Play Pro Yakyuu '90 (Japan)=베스트 플레이 프로야구 - 새로운 데이터
Best Play Pro Yakyuu (Japan) (Rev 1)=베스트 플레이 프로야구
Best Play Pro Yakyuu (Japan)=베스트 플레이 프로야구 (일본판)
Best Play Pro Yakyuu II (Japan)=베스트 플레이 프로야구 2
Best Play Pro Yakyuu Special (Japan) (Rev 1)=베스트 플레이 프로야구 스페셜
Best Play Pro Yakyuu Special (Japan)=베스트 플레이 프로야구 스페셜 (일본판)
Bible Adventures (USA) (Unl)=성경 모험 (해적판)
Bible Adventures (USA) (v1.1) (Unl)=성경 모험 (v1.1)(해적판)
Bible Adventures (USA) (v1.2) (Unl)=성경 모험 (v1.2)(해적판)
Bible Adventures (USA) (v1.3) (Unl)=성경 모험 (v1.3)(해적판)
Bible Adventures (USA) (v1.4) (Unl)=성경 모험 (v1.4)(해적판)
Bible Adventures (USA) (v1.5) (Unl)=성경 모험
Bible Buffet (USA) (v6.0) (Unl)=성경 뷔페
Big Nose and the Witchdoctor (USA) (Beta) (Unl)=빅 노즈 앤드 더 위치닥터 (베타)(해적판)
Big Nose Freaks Out (USA) (Unl)=빅 노즈 프릭스 아웃
Big Nose the Caveman (USA) (Unl)=빅 노즈 더 케이브맨
Bigfoot (Europe)=빅풋
Bigfoot (USA)=빅풋
Bikkuri Nekketsu Shin Kiroku! - Harukanaru Kin Medal (Japan)=깜짝 열혈 신기록 ! - 머나먼 금메달 (일본판)
Bikkuriman World - Gekitou Sei Senshi (Japan)=비쿠리맨 월드 - 격투 성전사
Bill & Ted's Excellent Video Game Adventure (USA)=빌& 테드의 엑설런트 비디오 게임 어드밴쳐
Bill Elliott's NASCAR Challenge (USA)=빌 엘리엇의 나스카 챌린지
Binary Land (Japan)=바이너리 랜드
Bingo (Asia) (C&E) (Unl)=빙고 (아시아판)(해적판)
Bingo (Asia) (TXC) (Unl)=빙고 (아시아판)(해적판)
Bingo 75 (Asia) (Ja) (Unl)=빙고 75
BinGuo 75 (Asia) (Ja) (Unl)=빙고 75 (아시아판)(일본어)(해적판)
Bio Force Ape (Japan) (En) (Proto)=바이오포스 에이프
Bio Miracle Bokutte Upa (Japan)=바이오 미라클 나는 우파
Bio Senshi Dan - Increaser Tono Tatakai (Japan)=바이오 전사 단 - 인크리서의 전투
Bionic Commando (Europe)=바이오닉 코만도
Bionic Commando (USA)=바이오닉 코만도
Bird Week (Japan)=버드 위크
Black Bass II, The (Japan)=블랙 배쓰 2 (일본판)
Black Bass, The (Japan)=블랙 배쓰
Black Bass, The (USA)=블랙 배쓰
Black Dragon (Korea) (Unl)=블랙 드래곤 (한국판)(해적판)
Blackjack (USA) (Unl)=블랙잭
Blades of Steel (Europe) (Virtual Console)=블레이드 오브 스틸 (유럽판)(버추얼 콘솔)
Blades of Steel (Europe)=블레이드 오브 스틸
Blades of Steel (USA) (Virtual Console)=블레이드 오브 스틸 (버추얼 콘솔)
Blades of Steel (USA)=블레이드 오브 스틸
Blaster Master (Europe)=블래스터 마스터
Blaster Master (Japan) (Virtual Console)=블래스터 마스터 (일본판)(버추얼 콘솔)
Blaster Master (USA) (Beta) (1988-05-20)=블래스터 마스터 (베타)
Blaster Master (USA)=블래스터 마스터
Blaster Master (USA, Europe) (Virtual Console)=블래스터 마스터 (미국,유럽판)(버추얼 콘솔)
Block Out (USA) (Proto)=블럭 아웃
Blodia Land - Puzzle Quest (Japan)=블로디아 랜드 - 퍼즐 퀘스트
Bloody Warriors - Shan-Go no Gyakushuu (Japan)=블러디 워리어스 - 산고의 역습
Bloque Magico, El (Spain) (Gluk Video) (Unl)=매직 블록 (스페인판)(글럭 비디오)(해적판)
Blue Marlin, The (Japan)=블루 마린 (일본판)
Blue Marlin, The (USA)=블루 마린
Blue Shadow (Europe)=블루 쉐도우
Blues Brothers, The (Europe)=부르스 브라더스
Blues Brothers, The (USA)=부르스 브라더스
BMX Simulator (Asia) (En) (Unl)=BMX 시뮬레이터
Bo Jackson Baseball (USA)=보 잭슨 베이스 볼
Bokosuka Wars (Japan)=보코즈카 전쟁
Bomber King (Japan)=봄버킹 (일본판)
Bomber Man (Japan)=봄버맨 (일본판)
Bomber Man II (Japan)=봄버맨 2 (일본판)
Bomberman (USA)=봄버맨
Bomberman II (USA)=봄버맨 2
Bonk's Adventure (USA)=봉크의 모험
Booby Kids (Japan)=부비 키즈
Booky Man (Spain) (Gluk Video) (Unl)=부키 맨
Boulder Dash (Europe)=볼더 대시
Boulder Dash (Japan)=볼더 대시 (일본판)
Boulder Dash (USA)=볼더 대시
Bowling (USA) (Proto)=볼링 (시험판)
Bram Stoker's Dracula (Europe)=브램 스토커의 드라큘라
Bram Stoker's Dracula (USA)=브램 스토커의 드라큘라
Break Time - The National Pool Tour (USA)=브레이크 타임 - 내셔널 풀 투어
BreakThru (USA)=브레이크스루!돌파구
Brilliant Com Cocoma Pack 1 (Korea) (Unl)=꼬꼬마 팩 1
Brilliant Com Cocoma Pack 2 (Korea) (Unl)=꼬꼬마 팩 2
Brush Roller (Asia) (Ja) (Unl)=브러쉬 롤러 (아시아판)(일본어)(해적판)
Bubble Bath Babes (USA) (Unl)=거품 욕조 아가씨 (해적판)
Bubble Bobble (Europe) (Virtual Console)=버블보블 (유럽판)(버추얼 콘솔)
Bubble Bobble (Europe)=버블보블
Bubble Bobble (USA) (Virtual Console)=버블보블 (버추얼 콘솔)
Bubble Bobble (USA)=버블보블
Bubble Bobble 2 (Japan)=버블보블 2 (일본판)
Bubble Bobble Part 2 (USA)=버블보블 파트 2
Bucky O'Hare (Europe)=버키 오 헤어
Bucky O'Hare (Japan)=버키 오 헤어 (일본판)
Bucky O'Hare (USA)=버키 오 헤어
Buggy Popper (Japan)=부기 파퍼 - 범프&점프 (일본판)
Bugs Bunny Birthday Bash (USA) (Beta) [b]=벅스 바니 생일잔치 (베타)
Bugs Bunny Birthday Blowout, The (USA)=벅스 바니 생일잔치
Bugs Bunny Blowout, The (Europe)=벅스 바니 블로우아웃
Bugs Bunny Crazy Castle, The (USA)=벅스 바니 정신없는 성
Bugs Bunny Fun House (USA) (Beta)=벅스 바니 재밌는 집 (베타)
BugTris (Korea) (Unl)=버그트리스
Bump 'n' Jump (USA)=범프 앤 점프
Burai Fighter (Europe)=무뢰 파이터
Burai Fighter (Japan)=무뢰 파이터 (일본판)
Burai Fighter (USA)=무뢰 파이터
BurgerTime (Japan)=버거타임 (일본판)
BurgerTime (USA)=버거타임
Business Wars (Japan)=비즈니스 전쟁
Buzz & Waldog (USA) (Proto) (Unl)=버즈 와 왈도그 (시험판)(해적판)
Cabal (USA)=카발
Cadillac (Japan) (Sample)=캐딜락 (일본판)(샘플)
Cadillac (Japan)=캐딜락
Caesars Palace (USA) (Beta)=시저스 팰리스 (베타)
Caesars Palace (USA)=시저스 팰리스
California Games (Europe)=캘리포니아 게임즈
California Games (USA)=캘리포니아 게임즈
California Raisins - The Grape Escape (USA) (Proto 1)=캘리포니아 래이진스 (시험판 1)
California Raisins - The Grape Escape (USA) (Proto 2)=캘리포니아 래이진스
Caltron - 6 in 1 (USA) (Unl)=6 in 1 합팩
Caltron - 9 in 1 (USA) (Proto) (Unl)=9 in 1 합팩
Capcom Barcelona '92 (Japan)=캡콤 바르셀로나 (일본판)
Capcom's Gold Medal Challenge '92 (Europe)=캡콤 금매달 챌린지 92
Capcom's Gold Medal Challenge '92 (USA)=캡콤 금매달 챌린지 92
Captain America and the Avengers (Australia)=캡틴 아메리카와 어벤져스 (호주판)
Captain America and the Avengers (USA)=캡틴 아메리카와 어벤져스
Captain Comic - The Adventure (USA) (Unl)=캡틴 코믹의 모험
Captain ED (Japan)=캡틴 ED
Captain Planet and the Planeteers (Europe)=출동! 지구 특공대
Captain Planet and the Planeteers (USA)=출동! 지구 특공대
Captain Saver (Japan)=캡틴 세이버 (일본판)
Captain Silver (Japan)=캡틴 실버
Captain Skyhawk (Europe)=캡틴 스카이 호크
Captain Skyhawk (USA) (Rev 1)=캡틴 스카이 호크 (개정판 1)
Captain Skyhawk (USA)=캡틴 스카이 호크
Captain Tsubasa (Japan)=캡틴 츠바사 (일본판)
Captain Tsubasa II - Super Striker (Japan)=캡틴 츠바사 2 - 슈퍼 스트라이커
Casino Derby (Japan)=카지노 경마
Casino Kid (USA)=카지노 키드
Casino Kid II (USA)=카지노 키드 2
Castelian (Europe)=캐스텔리안
Castelian (USA)=캐스텔리안
Castle Excellent (Japan)=캐슬 엑설런트 (일본판)
Castle of Deceit (USA) (Unl)=캐슬 오브 디시트
Castle of Dragon (USA)=캐슬 오브 드래곤
Castle Quest (Japan)=캐슬 퀘스트
Castlequest (USA)=캐슬 퀘스트
Castlevania (Europe) (Virtual Console)=악마성 드라큘라 (유럽판)(버추얼 콘솔)
Castlevania (Europe)=악마성 드라큘라
Castlevania (USA) (Castlevania Anniversary Collection)=악마성 드라큘라 (악마성 기념판 컬렉션)
Castlevania (USA) (Rev 1) (Virtual Console)=악마성 드라큘라 (개정판 1)(버추얼 콘솔)
Castlevania (USA) (Rev 1)=악마성 드라큘라 (개정판 1)
Castlevania (USA)=악마성 드라큘라
Castlevania II - Simon's Quest (Europe)=악마성 드라큘라 2 - 사이몬의 퀘스트
Castlevania II - Simon's Quest (USA) (Castlevania Anniversary Collection)=악마성 드라큘라 2 - 사이몬의 퀘스트 (악마성 기념판 컬렉션)
Castlevania II - Simon's Quest (USA)=악마성 드라큘라 2 - 사이몬의 퀘스트
Castlevania III - Dracula's Curse (Europe) (Virtual Console)=악마성 드라큘라 3 - 드라큘라의 저주 (유럽판)(버추얼 콘솔)
Castlevania III - Dracula's Curse (Europe)=악마성 드라큘라 3 - 드라큘라의 저주
Castlevania III - Dracula's Curse (USA) (Castlevania Anniversary Collection)=악마성 드라큘라 3 - 드라큘라의 저주 (악마성 기념판 컬렉션)
Castlevania III - Dracula's Curse (USA) (Virtual Console)=악마성 드라큘라 3 - 드라큘라의 저주 (버추얼 콘솔)
Castlevania III - Dracula's Curse (USA)=악마성 드라큘라 3 - 드라큘라의 저주
Cat Ninden Teyandee (Japan)=고양이 닌자 테얀데에
Caveman Games (USA)=원시인 경기
Chack'n Pop (Japan)=츄군 팝 / 채크 앤 팝
Challenge of the Dragon (Asia) (Ja) (Sachen) (Unl)=챌린지 오브 더 드래곤 (아시아판)(일본어)(사첸)(해적판)
Challenge of the Dragon (USA) (Color Dreams) (Unl)=챌린지 오브 더 드래곤
Challenger (Japan)=챌린저
Championship Bowling (Japan)=챔피언십 볼링 (일본판)
Championship Bowling (USA)=챔피언십 볼링
Championship Lode Runner (Japan)=챔피언십 로드 러너
Championship Pool (USA)=챔피언십 풀
Championship Rally (Europe)=챔피언십 랠리
Chaos World (Japan)=카오스 월드 - 혼돈 세계
Cheetahmen II (USA) (Unl)=치타맨 2
Chess Academy (Asia) (Ja) (NTSC) (Unl)=체스 아케데미
Chessmaster, The (Europe)=체스마스터
Chessmaster, The (USA) (Rev 1)=체스마스터 (개정판 1)
Chessmaster, The (USA)=체스마스터
Chester Field - Ankoku Shin e no Chousen (Japan) (Beta)=체스터 필드 - 암흑 신에게 도전 (일본판)(베타)
Chester Field - Ankoku Shin e no Chousen (Japan)=체스터 필드 - 암흑 신에게 도전
Chevaliers du Zodiaque, Les - La Legende d'Or (France)=세인트 세이야 - 황금전설 (프랑스판)
Chibi Maruko-chan - Uki Uki Shopping (Japan)=치비 마루코짱 - 들뜬 쇼핑
Chiisana Obake - Acchi Socchi Kocchi (Japan)=작은 도깨비 - 이치 소치 코치
Chik Bik Ji Jin - Saam Gwok Ji (Asia) (Ja) (Unl)=삼국지 - 적벽대전
Chiki Chiki Machine Mou Race (Japan)=치키치키 머신 맹 레이스 (일본판)
Chiller (Australia) (Unl)=칠러 (호주판)(해적판)
Chiller (USA) (Unl)=칠러
Chinese Checkers (Asia) (Ja) (NTSC) (Unl)=차이니즈 체커
Chinese Checkers (Asia) (Ja) (PAL) (Unl)=차이니즈 체커 (아시아판)(일본어)(PAL)(해적판)
Chinese KungFu (Asia) (Ja) (Unl)=소림무사 - 차이니즈 쿵푸
Chip 'n Dale - Rescue Rangers (Europe) (Beta)=칩 앤 데일 - 레스큐 레인져스 (유럽판)(베타)
Chip 'n Dale - Rescue Rangers (Europe)=칩 앤 데일 - 레스큐 레인져스
Chip 'n Dale - Rescue Rangers (USA)=칩 앤 데일 - 레스큐 레인져스
Chip 'n Dale - Rescue Rangers 2 (Europe)=칩 앤 데일 - 레스큐 레인져스 2
Chip 'n Dale - Rescue Rangers 2 (USA) (Beta)=칩 앤 데일 - 레스큐 레인져스 2 (베타)
Chip 'n Dale - Rescue Rangers 2 (USA)=칩 앤 데일 - 레스큐 레인져스 2
Chip to Dale no Daisakusen (Japan)=칩과 데일의 대작전 (일본판)
Chip to Dale no Daisakusen 2 (Japan)=칩과 데일의 대작전 2 (일본판)
Chip's Challenge (USA) (v0.924B) (Proto)=칩스 챌린지
Chitei Senkuu Vazolder (Japan)=지저전공 바조루다 (일본판)
Chiyonofuji no Ooichou (Japan)=천세 후지의 대은행
Choplifter (Japan) (En) (Rev 1)=촙리프터
Choplifter (Japan) (En)=촙리프터 (일본판)(영어)
Chou Fuyuu Yousai Exed Exes (Japan)=초부유요새 엑시드 엑시스
Chou-Wakusei Senki - MetaFight (Japan)=초혹성전기 - 메타파이트 (일본판)
Choujikuu Yousai - Macross (Japan)=초시공요새 - 마크로스
Choujin - Ultra Baseball (Japan) (Virtual Console)=초인 - 울트라 베이스볼 (일본판)(버추얼 콘솔)
Choujin - Ultra Baseball (Japan)=초인 - 울트라 베이스볼 (일본판)
Choujin Sentai Jetman (Japan)=조인 전대 제트맨
Choujinrou Senki - Warwolf (Japan)=초인랑전기 워울프 (일본판)
Chris Evert & Ivan Lendl in Top Players' Tennis (USA)=크리스 에버트 & 이반 렌들 탑플레어 테니스
Chubby Cherub (USA)=츄비 체럽
Chuck Yeager's Fighter Combat (USA) (Proto)=척 예거의 파이터 컴뱃
Chuugoku Janshi Story - Tonfuu (Japan)=중국 작사 스토리 - 동풍
Chuugoku Senseijutsu (Japan)=중국 점성술
Chuugoku Taitei (Asia) (Ja) (Unl)=중국대물
Chuuka Taisen (Japan)=중화대선
Circus Caper (USA)=서커스 케이퍼
Circus Charlie (Japan)=서커스 찰리
City Adventure Touch - Mystery of Triangle (Japan)=시티 어드벤처 터치 - 미스터리 오브 트라이앵글
City Connection (Europe) (Virtual Console)=시티 커넥션 (유럽판)(버추얼 콘솔)
City Connection (Europe)=시티 커넥션
City Connection (Japan) (Virtual Console, Switch Online)=시티 커넥션 (일본판)
City Connection (Japan)=시티 커넥션 (일본판)
City Connection (USA)=시티 커넥션
Clash at Demonhead (USA)=클래쉬 엣 데몬헤드
Classic Concentration (USA)=클래식 컨센트레이션
Cliffhanger (USA)=클리프행어
Clu Clu Land (World) (GameCube Edition)=클루 클루 랜드 (세계판)(게임큐브 버전)
Clu Clu Land (World) (Virtual Console)=클루 클루 랜드 (세계판)(버추얼 콘솔)
Clu Clu Land (World)=클루 클루 랜드
Cobra Command (Japan)=코브라 코만도 (일본판)
Cobra Command (USA)=코브라 코만도
Cobra Mission (Asia) (Ja) (Unl)=코브라 미션
Cobra Triangle (Europe)=코브라 트라이앵글
Cobra Triangle (USA)=코브라 트라이앵글
Cocoron (Japan)=코코론
Code Name - Viper (USA)=코드 네임 - 바이퍼
Color a Dinosaur (USA) (Beta)=공룡 색칠공부 (베타)
Color a Dinosaur (USA)=공룡 색칠공부
Colorful Dragon (Asia) (Ja) (PAL) (Unl)=컬러풀 드래곤 (아시아판)(일본어)(PAL)(해적판)
Columbus - Ougon no Yoake (Japan) (Sample)=콜롬버스- 황금의 새벽 (일본판)(샘플)
Columbus - Ougon no Yoake (Japan)=콜롬버스- 황금의 새벽
Commando (USA)=전장의 이리 / 코만도
Conan (USA)=코난
Conflict (Japan)=컨플릭트 (일본판)
Conflict (USA)=컨플릭트
Conquest of the Crystal Palace (USA)=컨퀘스트 오브 더 크리스탈 팰리스
Contra (Japan) (Sample)=혼두라 (일본판)(샘플)
Contra (Japan)=혼두라 (일본판)
Contra (USA)=혼두라
Contra Force (USA)=혼두라 포스
Cool World (USA)=쿨 월드
Corre Benny (Spain) (Gluk Video) (Unl)=고 베니 (스페인판)(글럭 비디오)(해적판)
Corvette ZR-1 Challenge (Europe)=콜벳 ZR-1 챌린지
Cosmic Epsilon (Japan)=코스믹 입실론
Cosmic Spacehead (Europe) (En,Fr,De,Es) (Unl)=코즈믹 스페이스헤드
Cosmic Wars (Japan)=코스믹 워즈
Cosmo Genesis (Japan)=코스모 제네시스 (일본판)
Cosmo Police Galivan (Japan)=코스모 폴리스 갈리반
Cosmos Cop (Asia) (En) (Mega Soft) (Unl)=코스모스 캅
Cosmos Cop (Spain) (Gluk Video) (Unl)=코스모스 캅 (스페인판)(글럭 비디오)(해적판)
Cowboy Kid (USA)=카우보이 키드
Crackout (Europe)=크랙아웃
Crackout (USA) (Proto)=크랙아웃 (시험판)
Crash 'n' the Boys - Street Challenge (USA)=크래쉬 앤 보이즈 - 스트리트 챌린지
Crayon Shin-chan - Ora to Poi Poi (Japan)=짱구는 못말려 - 나랑 뽀이뽀이
Crazy Climber (Japan)=크레이지 클라이머
Creatom (Spain) (Gluk Video) (Unl)=크리에이톰
Crime Busters (Brazil) (Unl)=크라임 버스터즈
Crisis Force (Japan) (Sample)=크라이시스 포스 (일본판)(샘플)
Crisis Force (Japan)=크라이시스 포스
CrossFire (Japan)=크로스파이어
CrossFire (USA) (Proto)=크로스파이어 (시험판)
Crystal Mines (Korea) (Unl)=크리스탈 마인 (한국판)(해적판)
Crystal Mines (USA) (Unl)=크리스탈 마인
Crystalis (USA) (Beta)=크리스탈리스 (베타)
Crystalis (USA)=크리스탈리스
Crystalis (USA, Europe) (SNK 40th Anniversary Collection)=크리스탈리스 (미국,유럽판)
Cyber Stadium Series - Base Wars (USA)=사버 스타디움 시리즈 - 베이스 워즈
Cyberball (USA)=사이버볼
Cybernoid - The Fighting Machine (USA)=사이버노이드 - 파이팅 머신
Cycle Race - Road Man (Japan)=사이클 레이스 - 로드 맨
Dai-2-ji Super Robot Taisen (Japan)=제2차 슈퍼로봇대전
Daikaijuu Deburas (Japan)=대괴수 데브라스
Daikoukai Jidai (Japan)=대항해시대 (일본판)
Daiku no Gen-san (Japan)=목수 겐씨 (일본판)
Daiku no Gen-san 2 - Akage no Dan no Gyakushuu (Japan)=목수 겐씨2 - 적모단의 역습
Daisenryaku (Japan)=대전략
Daiva - Imperial of Nirsartia (Japan)=디바- 나사티아의 옥좌
Dance Aerobics (USA)=댄스 에어로빅
Dancing Blocks (Asia) (Ja) (PAL) (Unl)=댄싱 블록
Danny Sullivan's Indy Heat (Europe)=대니 설리반의 인디 히트
Danny Sullivan's Indy Heat (USA)=대니 설리반의 인디 히트
Dao Shuai (Asia) (Ja) (Unl)=도수 (아시아판)(일본어)(해적판)
Dark Lord (Japan)=다크 로드
Darkman (Europe)=다크맨
Darkman (USA)=다크맨
Darkwing Duck (Europe)=다크윙 덕
Darkwing Duck (Germany)=다크윙 덕 (독일판)
Darkwing Duck (USA) (Beta)=다크윙 덕 (베타)
Darkwing Duck (USA)=다크윙 덕
Dash Galaxy in the Alien Asylum (USA)=대쉬 겔럭시 인 더 에일리언 어사일럼
Dash Yarou (Japan)=대쉬 야랑 (일본판)
Datach - Battle Rush - Build Up Robot Tournament (Japan)=데이터크 - 배틀러시 - 빌드 업 로봇 토너먼트
Datach - Crayon Shin-chan - Ora to Poi Poi (Japan)=데이터크 - 짱구는 못말려 - 나하고 뽀이뽀이 (일본판)
Datach - Dragon Ball Z - Gekitou Tenkaichi Budoukai (Japan)=데이터크 - 드래곤 볼 Z - 천하제일 무도회
Datach - J.League Super Top Players (Japan)=데이터크 - J 리그 슈퍼 탑 플레이어
Datach - SD Gundam - Gundam Wars (Japan)=데이터크 - SD 건담 - 건담 워즈
Datach - Ultraman Club - Supokon Fight! (Japan)=데이터크 - 울트라맨 클럽 - 수포콘 파이트!
Datach - Yu Yu Hakusho - Bakutou Ankoku Bujutsukai (Japan)=데이터크 - 유유백서 - 폭투암흑무술회
Datsugoku (Japan)=탈옥 (일본판)
David Crane's A Boy and His Blob - Trouble on Blobolonia (Europe) (Rev 1)=데이비드 크레인의 소년과 블롭 - 브로볼라니아의 위기
David Crane's A Boy and His Blob - Trouble on Blobolonia (Europe)=데이비드 크레인의 소년과 블롭 - 브로볼라니아의 위기 (유럽판)
David Crane's A Boy and His Blob - Trouble on Blobolonia (USA)=데이비드 크레인의 소년과 블롭 - 브로볼라니아의 위기
Day Dreamin' Davey (USA)=데이 드리밍데이비
Days of Thunder (Europe)=데이즈 오브 썬더
Days of Thunder (USA)=데이즈 오브 썬더
De-Block (Japan)=디블럭
Dead Fox (Japan)=데드 폭스 (일본판)
Deadly Towers (USA)=죽음의 탑
Death Race (USA) (Unl)=데스 레이스
Deathbots (USA) (Rev 1) (Unl)=데스봇츠
Deathbots (USA) (Unl)=데스봇츠 (해적판)
Decathlon (Asia) (Ja) (Unl)=디캐슬런
Deep Dungeon III - Yuushi e no Tabi (Japan)=딥 던젼 3 - 용사의 여행
Deep Dungeon IV - Kuro no Youjutsushi (Japan)=딥 전젼 4 - 흑의 요술사
Defender II (USA)=디펜더 2
Defender of the Crown (Europe)=디펜더 오브 더 크라운
Defender of the Crown (France)=디펜더 오브 더 크라운 (프랑스판)
Defender of the Crown (USA)=디펜더 오브 더 크라운
Defenders of Dynatron City (USA)=디펜더스 오브 다이너트론 시티
Deja Vu (Sweden)=데자뷰 (스웨덴판)
Deja Vu (USA)=데자뷰
Deja Vu - A Nightmare Comes True!! (Japan)=데자뷰 - 악몽이 정말로 왔다 (일본판)
Demon Sword (USA)=데몬 소드
Dengeki - Big Bang! (Japan) (Beta)=전격 - 빅뱅! (일본판)(베타)
Dengeki - Big Bang! (Japan)=전격 - 빅뱅! (일본판)
Densetsu no Kishi - Elrond (Japan)=전설의 기사 - 앨론드 (일본판)
Derby Stallion - Zenkoku Ban (Japan)=더비 스탈리온 - 전국편
Desert Commander (USA)=데져트 커맨더
Destination Earthstar (USA)=데스티네이션 어스 스타
Destiny of an Emperor (USA)=데스티니 오브 언 엠퍼러
Destructor, El (Spain) (Gluk Video) (Unl)=디스트럭터
Devil Man (Japan)=데빌맨
Devil World (Europe)=마수의 왕국 / 데빌 월드
Devil World (Japan) (Rev 1)=마수의 왕국 / 데빌 월드 (일본판)(개정판 1)
Devil World (Japan)=마수의 왕국 / 데빌 월드 (일본판)
Dick Tracy (USA)=딕 트레이시
Die Hard (Europe)=다이하드
Die Hard (Japan)=다이하드 (일본판)
Die Hard (USA)=다이하드
Dig Dug (Japan)=디그 더그
Dig Dug (World) (Namcot Collection, Namco Museum Archives Vol 1)=디그 더그 (세계판)
Dig Dug II (Japan)=디그 더그 2 (일본판)
Dig Dug II (USA, Europe) (Namco Museum Archives Vol 2)=디그 더그 2 (미국,유럽판)
Dig Dug II - Trouble in Paradise (USA)=디그 더그 2
Dig Dug II - Trouble in Paradise (USA, Europe) (Virtual Console)=디그 더그 2 (미국,유럽판)(버추얼 콘솔)
Digger - The Legend of the Lost City (USA)=디거 - 레전드 오브 로스트 시티
Digger T. Rock - The Legend of the Lost City (Europe)=디거 T. 록 - 레전드 오브 로스트 시티
Digital Devil Story - Megami Tensei (Japan) (Namcot Collection)=여신전생 - 디지털 데빌 스토리 (일본판)
Digital Devil Story - Megami Tensei (Japan)=여신전생 - 디지털 데빌 스토리
Digital Devil Story - Megami Tensei II (Japan) (Rev A)=여신전생 2 - 디지털 데빌 스토리
Digital Devil Story - Megami Tensei II (Japan)=여신전생 2 - 디지털 데빌 스토리 (일본판)
Dino Hockey (USA) (Proto 1)=디노 하키 (시험판 1)
Dino Hockey (USA) (Proto 2)=디노 하키
Dirty Harry (USA)=더티 해리
Dizzy the Adventurer (USA) (Aladdin Compact Cartridge) (Unl)=디지의 모험
Doki! Doki! Yuuenchi - Crazy Land Daisakusen (Japan)=두근 두근 유원지 - 크레이지 랜드 대작전 (일본판)
Dokuganryuu Masamune (Japan)=독안룡 마사무네
Don Doko Don (Japan)=돈 도코 돈
Don Doko Don 2 (Japan)=돈 도코 돈 2
Donald Duck (Japan)=도날드 덕 (일본판)
Donald Land (Japan)=도날드 랜드
Dong Dong Nao 1 (Asia) (Ja) (Unl)=동 동 나오 1 (아시아판)(일본어)(해적판)
Dong Dong Nao II - Guo Zhong Ying Wen (Yi) (Asia) (Ja) (Unl)=동 동 나오 2 - 국중영문
Donkey Kong (Japan)=동키콩 (일본판)
Donkey Kong (World) (Rev 1) (GameCube Edition)=동키콩 (세계판)(개정판 1)(게임큐브 버전)
Donkey Kong (World) (Rev 1)=동키콩
Donkey Kong - Original Edition (Europe) (Virtual Console) (NTSC)=동키콩 - 오리지널 에디션 (유럽판)(버추얼 콘솔)(NTSC)
Donkey Kong - Original Edition (USA) (3DS Virtual Console)=동키콩 - 오리지널 에디션
Donkey Kong 3 (World) (GameCube Edition)=동키콩 3 (세계판)(게임큐브 버전)
Donkey Kong 3 (World)=동키콩 3
Donkey Kong Classics (USA, Europe)=동키콩 클래식
Donkey Kong Jr. (Japan)=동키콩 쥬니어 (일본판)
Donkey Kong Jr. (World) (Rev 1) (GameCube Edition)=동키콩 쥬니어 (세계판)(개정판 1)(게임큐브 버전)
Donkey Kong Jr. (World) (Rev 1)=동키콩 쥬니어
Donkey Kong Jr. + Jr. Lesson (Japan)=동키콩 쥬니어 + 쥬니어 레슨
Donkey Kong Jr. Math (USA, Europe)=동키콩 쥬니어 산수
Donkey Kong Jr. no Sansuu Asobi (Japan) (GameCube Edition)=동키콩 주니어의 산수 놀이 (일본판)(게임큐브 버전)
Donkey Kong Jr. no Sansuu Asobi (Japan)=동키콩 주니어의 산수 놀이 (일본판)
Dooly Bravo Land (Korea) (Unl)=둘리 부라보 랜드
Door Door (Japan)=도어 도어
Doraemon (Japan) (Rev A)=도라에몽
Doraemon (Japan)=도라에몽 (일본판)
Doraemon - Giga Zombie no Gyakushuu (Japan)=도라에몽 - 기가좀비의 역습
Dou Zhi Pin Pan - Wisdom Boy (Asia) (Unl)=투지병반 - 위지덤 보이
Double Dare (USA)=더블 데어
Double Dragon (Europe) (Virtual Console)=더블 드래곤 / 쌍절룡 (유럽판)(버추얼 콘솔)
Double Dragon (Europe)=더블 드래곤 / 쌍절룡
Double Dragon (USA)=더블 드래곤 / 쌍절룡
Double Dragon - Sou Setsu Ryuu (Japan)=더블 드래곤 / 쌍절룡 (일본판)
Double Dragon II - The Revenge (Europe)=더블 드래곤 2 - 복수 / 쌍절룡 2
Double Dragon II - The Revenge (USA) (Rev 1)=더블 드래곤 2 - 복수 / 쌍절룡 2 (개정판 1)
Double Dragon II - The Revenge (USA)=더블 드래곤 2 - 복수 / 쌍절룡 2
Double Dragon III - The Sacred Stones (Europe)=더블 드래곤 3 - 스카드 스톤
Double Dragon III - The Sacred Stones (USA)=더블 드래곤 3 - 스카드 스톤
Double Dribble (Europe)=더블 드리블
Double Dribble (USA) (Rev 1)=더블 드리블 (개정판 1)
Double Dribble (USA)=더블 드리블
Double Moon Densetsu (Japan)=두개 달 전설
Double Strike - Aerial Attack Force (USA) (v1.0) (Unl)=더블 스트라이크- 에어리얼 어택 포스 (v1.0)(해적판)
Double Strike - Aerial Attack Force (USA) (v1.1) (Unl)=더블 스트라이크- 에어리얼 어택 포스
Dough Boy (Japan)=보병소년
Downtown - Nekketsu Koushinkyoku - Soreyuke Daiundoukai (Japan)=다운타운 - 열혈 행진곡 - 그대로 가라 대운동회
Downtown - Nekketsu Monogatari (Japan) (Virtual Console)=다운타운 - 열혈물어 (일본판)(버추얼 콘솔)
Downtown - Nekketsu Monogatari (Japan)=다운타운 - 열혈물어 (일본판)
Downtown Special - Kunio-kun no Jidaigeki Da yo Zenin Shuugou! (Japan)=다운타운 스페셜 - 쿠니오군의 시대극이야 전원 집합!
Dr. Chaos (USA)=닥터 카오스
Dr. Jekyll and Mr. Hyde (USA)=지킬박사와 하이드
Dr. Mario (Europe)=닥터 마리오
Dr. Mario (Japan, USA) (Rev 1)=닥터 마리오 (개정판 1)
Dr. Mario (Japan, USA)=닥터 마리오
Dr. Mario (USA) (Beta) (1990-04-27)=닥터 마리오 (베타)(1990-04-27)
Dr. Mario (USA) (Beta) (After 1990-04-27)=닥터 마리오 (베타)
Drac's Night Out (USA) (Proto)=드렉의 밤 외출
Dragon Ball - Daimaou Fukkatsu (Japan)=드래곤 볼 - 대마왕 부활
Dragon Ball - Le Secret du Dragon (France) (Rev 1)=드래곤 볼 - 신룡의 수수께끼 (프랑스판)(개정판 1)
Dragon Ball - Le Secret du Dragon (France)=드래곤 볼 - 신룡의 수수께끼 (프랑스판)
Dragon Ball - Shen Long no Nazo (Japan)=드래곤 볼 - 신룡의 수수께끼 (일본판)
Dragon Ball 3 - Gokuu Den (Japan) (Rev 1)=드래곤 볼 3 - 오공전
Dragon Ball 3 - Gokuu Den (Japan)=드래곤 볼 3 - 오공전 (일본판)
Dragon Ball Z - Kyoushuu! Saiya Jin (Japan)=드래곤 볼 Z - 강습 사이어 인
Dragon Ball Z Gaiden - Saiya Jin Zetsumetsu Keikaku (Japan)=드래곤 볼 외전 - 사이어 인 절멸 계획
Dragon Ball Z II - Gekishin Freeza!! (Japan) (Rev 1)=드래곤 볼 Z 2 - 격신 프리더
Dragon Ball Z II - Gekishin Freeza!! (Japan)=드래곤 볼 Z 2 - 격신 프리더 (일본판)
Dragon Ball Z III - Ressen Jinzou Ningen (Japan)=드래곤 볼 Z 3 - 열전 인조 인간
Dragon Buster (Japan) (Virtual Console)=드래곤 버스터 (일본판)(버추얼 콘솔)
Dragon Buster (Japan)=드래곤 버스터
Dragon Buster (World) (Namcot Collection, Namco Museum Archives Vol 1)=드래곤 버스터 (세계판)
Dragon Buster II - Yami no Fuuin (Japan)=드래곤 버스터 2 - 암흑의 봉인
Dragon Buster II - Yami no Fuuin (USA, Europe) (Namco Museum Archives Vol 2)=드래곤 버스터 2 - 암흑의 봉인 (미국,유럽판)
Dragon Fighter (Japan)=드래곤 파이터 (일본판)
Dragon Fighter (USA)=드래곤 파이터
Dragon Ninja (Japan) (Rev A)=드래곤 닌자 (일본판)(개정판 A)
Dragon Ninja (Japan)=드래곤 닌자 (일본판)
Dragon Power (USA)=드레곤 파워
Dragon Quest (Japan)=드래곤 퀘스트 (일본판)
Dragon Quest II - Akuryou no Kamigami (Japan)=드래곤 퀘스트 2 - 악령의 신들 (일본판)
Dragon Quest III - Soshite Densetsu e... (Japan) (Rev 1)=드래곤 퀘스트 3 - 그리고 전설로 (일본판)(개정판 1)
Dragon Quest III - Soshite Densetsu e... (Japan)=드래곤 퀘스트 3 - 그리고 전설로 (일본판)
Dragon Quest IV - Michibikareshi Monotachi (Japan) (Rev 1)=드래곤 퀘스트 4 - 인도하는 자들 (일본판)(개정판 1)
Dragon Quest IV - Michibikareshi Monotachi (Japan)=드래곤 퀘스트 4 - 인도하는 자들 (일본판)
Dragon Scroll - Yomigaerishi Maryuu (Japan)=드래곤 스크롤 - 되살아난 마룡
Dragon Slayer IV - Drasle Family (Japan)=드래곤 슬레이어 4 - 드레슬레 패밀리 (일본판)
Dragon Spirit - Aratanaru Densetsu (Japan) (Namcot Collection)=드래곤 스피리트 - 새로운 전설 (일본판)
Dragon Spirit - Aratanaru Densetsu (Japan)=드래곤 스피리트 - 새로운 전설 (일본판)
Dragon Spirit - The New Legend (USA)=드래곤 스피리트 - 새로운 전설
Dragon Spirit - The New Legend (USA, Europe) (Namco Museum Archives Vol 1)=드래곤 스피리트 - 새로운 전설 (미국,유럽판)
Dragon Unit (Japan)=드래곤 유닛 (일본판)
Dragon Warrior (USA) (Rev 1)=드래곤 워리어
Dragon Warrior (USA)=드래곤 워리어
Dragon Warrior II (USA)=드래곤 워리어2
Dragon Warrior III (USA)=드래곤 워리어3
Dragon Warrior IV (USA)=드래곤 워리어4
Dragon Wars (Japan)=드래곤 워즈
Dragon Wars (USA) (Proto)=드래곤 워즈 (시험판)
Dragon's Lair (Europe)=드래곤즈 레어
Dragon's Lair (Japan)=드래곤즈 레어 (일본판)
Dragon's Lair (USA)=드래곤즈 레어
Dreamworld Pogie (Unknown) (Proto 1) (1993-10-19) (Unl)=드림월드 포기 (불명)(시험판 1)(해적판)
Dreamworld Pogie (Unknown) (Proto 2) (2016-xx-xx) (Unl)=드림월드 포기 (불명)(시험판 2)(해적판)
Dreamworld Pogie (Unknown) (Proto 3) (2017-xx-xx) (Unl)=드림월드 포기
Dropzone (Europe)=드롭존
Druaga no Tou (Japan)=드루아가 의 탑
Druaga no Tou (World) (Namcot Collection, Namco Museum Archives Vol 1)=드루아가 의 탑 (세계판)
Duck (Asia) (En) (Rev 1) (Unl)=덕 (아시아판)(영어)(개정판 1)(해적판)
Duck (Asia) (En) (Unl)=덕 (아시아판)(영어)(해적판)
Duck Hunt (World)=오리사냥
Duck Maze (Australia) (Unl)=덕 메이즈
DuckTales (Europe)=욕심쟁이 오리아저씨
DuckTales (USA) (Beta) (1989-05-25)=욕심쟁이 오리아저씨 (베타)
DuckTales (USA)=욕심쟁이 오리아저씨
DuckTales 2 (Europe) (Beta)=욕심쟁이 오리아저씨 2 (유럽판)(베타)
DuckTales 2 (Europe)=욕심쟁이 오리아저씨 2
DuckTales 2 (France)=욕심쟁이 오리아저씨 2 (프랑스판)
DuckTales 2 (Germany)=욕심쟁이 오리아저씨 2 (독일판)
DuckTales 2 (Japan)=욕심쟁이 오리아저씨 2 (일본판)
DuckTales 2 (USA)=욕심쟁이 오리아저씨 2
Dudes with Attitude (USA) (Rev 1) (Unl)=듀드 위드 애티듀드
Dudes with Attitude (USA) (Unl)=듀드 위드 애티듀드 (해적판)
Dungeon & Magic - Swords of Element (Japan)=던젼 & 매직 - 원소의 검 (일본판)
Dungeon Kid (Japan)=던전 키드
Dungeon Magic - Sword of the Elements (USA)=던젼 매직 - 소드 오브 엘레먼츠
Dusty Diamond's All-Star Softball (USA)=더스티 다이아몬즈 올스타 소프트볼
Dynablaster (Europe)=봄버맨 / 다이너 블래스터
Dynamite Batman (Japan)=다이너마이트 배트맨 (일본판)
Dynamite Bowl (Japan) (Rev A)=다이너마이트 보울
Dynamite Bowl (Japan)=다이너마이트 보울 (일본판)
Dynowarz - The Destruction of Spondylus (USA)=다이노워즈 - 생물의 멸망
EarthBound Beginnings (USA, Europe) (Virtual Console)=어스바운드 비기닝 (미국,유럽판)(버추얼 콘솔)
Eggerland - Meikyuu no Fukkatsu (Japan)=에거랜드 - 미궁의 부활
Egypt (Japan)=이집트
Elevator Action (Japan) (Rev 1) (Virtual Console)=엘리베이터 액션 (일본판)(개정판 1)(버추얼 콘솔)
Elevator Action (Japan) (Rev 1)=엘리베이터 액션 (일본판)(개정판 1)
Elevator Action (Japan)=엘리베이터 액션 (일본판)
Elevator Action (USA) (Virtual Console)=엘리베이터 액션 (버추얼 콘솔)
Elevator Action (USA)=엘리베이터 액션
Eliminator Boat Duel (Europe)=엘리미네이터 보트 듀얼
Eliminator Boat Duel (USA)=엘리미네이터 보트 듀얼
Elite (Europe) (En,Fr,De)=엘리트
Elite (USA) (Proto)=엘리트 (시험판)
Elnark no Zaihou (Japan)=엘나크의 보물
Elysion (Japan)=엘리시온
Emoyan no 10 Bai Pro Yakyuu (Japan)=에모얀의 10배 프로야구
Empereur, L' (Japan)=황제 (일본판)
Empereur, L' (USA)=황제
English, Pyramid (Korea) (Unl)=영어 피라미드 (한국판)(해적판)
Eric Cantona Football Challenge - Goal! 2 (Europe)=에릭 칸토나 풋볼 챌린지 - 골! 2
Erika to Satoru no Yume Bouken (Japan)=에리카와 사토루의 꿈 모험
Escape from Atlantis, The (USA) (Proto 1) (Unl)=아틀란티스 탈출 (시험판 1)(해적판)
Escape from Atlantis, The (USA) (Proto 2) (Unl)=아틀란티스 탈출
Esper Bouken Tai (Japan)=에스퍼 모험대 - 악마의 탑
Esper Dream 2 - Aratanaru Tatakai (Japan)=에스퍼 드림2 - 새로운 싸움
Excitebike (Europe) (Virtual Console)=익사이트 바이크 (유럽판)(버추얼 콘솔)
Excitebike (Europe)=익사이트 바이크
Excitebike (Japan, USA) (GameCube Edition)=익사이트 바이크 (게임큐브 버전)
Excitebike (Japan, USA) (Virtual Console)=익사이트 바이크 (버추얼 콘솔)
Excitebike (Japan, USA)=익사이트 바이크
Exciting Boxing (Japan)=익사이팅 복싱
Exciting Rally - World Rally Championship (Japan)=익사이팅 랠리 - 월드 랠리 챔피온쉽 (일본판)
Exerion (Japan) (En) (Proto) [b]=엑시리온
Exerion (Japan) (En)=엑시리온
Exodus - Journey to the Promised Land (USA) (v4.0) (Unl)=엑소더스 - 약속의 땅으로의 여행 (v4.0)(해적판)
Exodus - Journey to the Promised Land (USA) (v5.0) (Unl)=엑소더스 - 약속의 땅으로의 여행
Exploding Fist (USA) (Proto) (1990-05-22)=익스플로딩 피스트
Exploding Fist (USA) (Proto) (Earlier)=익스플로딩 피스트 (시험판)(초기판)
F-1 Race (Japan) (Beta)=F-1 레이스 (일본판)(베타)
F-1 Sensation (Japan)=F-1 센세이션 (일본판)
F-117A Stealth Fighter (USA)=F-177A 스텔스 파이터
F-15 City War (Asia) (En) (Idea-Tek) (Unl)=F-15 시티 워 (아시아판)(영어)(해적판)
F-15 City War (Spain) (Gluk Video) (Unl)=F-15 시티 워 (스페인판)(글럭 비디오)(해적판)
F-15 City War (USA) (v1.0) (Unl)=F-15 시티 워 (v1.0)(해적판)
F-15 City War (USA) (v1.1) (Unl)=F-15 시티 워
F-15 Strike Eagle (Europe)=F-15 스트라이크 이글
F-15 Strike Eagle (France) (En,Fr,Nl)=F-15 스트라이크 이글 (프랑스판)
F-15 Strike Eagle (Germany)=F-15 스트라이크 이글 (독일판)
F-15 Strike Eagle (Italy)=F-15 스트라이크 이글 (이탈리아판)
F-15 Strike Eagle (Sweden) (Sv,Da,Fi)=F-15 스트라이크 이글 (스웨덴판)
F-15 Strike Eagle (USA)=F-15 스트라이크 이글
F1 Circus (Japan)=F1 서커스
F1 Race (Japan)=F-1 레이스
Famicom Doubutsu Seitai Zukan! - Katte ni Shirokuma - Mori o Sukue no Maki! (Japan)=패미콤 동물 정체 도감! - 지멋대로 하얀곰 숲을 구하다
Famicom Igo Nyuumon (Japan)=패미컴 위기입문
Famicom Jump - Eiyuu Retsuden (Japan)=패미컴 점프 - 영웅열전
Famicom Jump II - Saikyou no 7 Nin (Japan)=패미컴 점프 2 - 최강의 7인
Famicom Meijin Sen (Japan) (Rev 1)=패미컴 명인전
Famicom Meijin Sen (Japan)=패미컴 명인전 (일본판)
Famicom Shougi - Ryuuousen (Japan) (Beta)=패미컴 장기 - 용왕전 (일본판)(베타)
Famicom Shougi - Ryuuousen (Japan)=패미컴 장기 - 용왕전
Famicom Top Management (Japan)=패미컴 탑 매니지먼트
Famicom Wars (Japan) (Virtual Console)=패미컴 워즈 (일본판)(버추얼 콘솔)
Famicom Wars (Japan)=패미컴 워즈
Famicom Yakyuu Ban (Japan)=패미컴 야구반
Family BASIC (Japan) (Rev 1)=패미컴 베이직 (일본판)(개정판 1)
Family BASIC (Japan) (Rev 2)=패미컴 베이직 (일본판)(개정판 2)
Family BASIC (Japan) (v1.0)=패미컴 베이직 (일본판)(v1.0)
Family BASIC (Japan) (v3.0)=패미컴 베이직
Family Block (Japan)=패밀리 블럭 (일본판)
Family Boxing (Japan)=패밀리 복싱 (일본판)
Family Circuit '91 (Japan) (En)=패밀리 서킷 91
Family Circuit (Japan) (Namcot Collection)=패밀리 서킷 (일본판)
Family Circuit (Japan)=패밀리 서킷
Family Feud (USA)=패밀리 퓨드
Family Jockey (Japan) (Namcot Collection)=패밀리 쟈키 (일본판)
Family Jockey (Japan)=패밀리 쟈키
Family Mahjong (Japan) (Rev A)=패밀리 마작
Family Mahjong (Japan)=패밀리 마작 (일본판)
Family Mahjong II - Shanghai e no Michi (Japan)=패밀리 마작2 - 상해의 도
Family Noraebang (Korea) (Unl)=패밀리 노래방
Family Pinball (Japan) (Namcot Collection)=패밀리 핀볼 (일본판)
Family Pinball (Japan)=패밀리 핀볼 (일본판)
Family Quiz - 4-nin wa Rival (Japan)=패밀리 퀴즈- 4인은 라이벌
Family School (Japan)=패밀리 스쿨
Family Tennis (Japan)=패밀리 테니스
Family Trainer 1 - Athletic World (Japan) (Rev 1)=패밀리 트레이너 1 - 애슬레틱 월드 (일본판)(개정판 1)
Family Trainer 1 - Athletic World (Japan)=패밀리 트레이너 1 - 애슬레틱 월드 (일본판)
Family Trainer 10 - Rairai Kyonsees (Japan) (Beta)=패밀리 트레이너 10 - 라이라이 강시 (일본판)(베타)
Family Trainer 10 - Rairai Kyonsees (Japan)=패밀리 트레이너 10 - 라이라이 강시
Family Trainer 2 - Running Stadium (Japan)=패밀리 트레이너 2 - 러닝 스타디움 (일본판)
Family Trainer 3 - Aerobics Studio (Japan)=패밀리 트레이너 3 - 에어로빅 스튜디오 (일본판)
Family Trainer 4 - Jogging Race (Japan)=패밀리 트레이너 4 - 조깅 레이스
Family Trainer 5 - Meiro Daisakusen (Japan)=패밀리 트레이너 5 - 미로 대 작전
Family Trainer 6 - Manhattan Police (Japan)=패밀리 트레이너 6 - 맨하탄 폴리스 (일본판)
Family Trainer 7 - Daiundoukai (Japan)=패밀리 트레이너 7 - 대 운동회 (일본판)
Family Trainer 8 - Totsugeki! Fuuun Takeshi-jou (Japan)=패밀리 트레이너 8 - 돌격 풍운 다케시성
Family Trainer 9 - Fuuun Takeshi-jou 2 (Japan)=패밀리 트레이너 9 - 풍운 다케시성 2
Famista '89 - Kaimaku Ban!! (Japan)=패미스타 89 - 개막판!!
Famista '90 (Japan)=패미스타 90
Famista '91 (Japan)=패미스타 91
Famista '92 (Japan)=패미스타 92
Famista '93 (Japan)=패미스타 93
Famista '94 (Japan)=패미스타 94
Fan Kong Jing Ying (Asia) (Unl)=반공정영
Fantastic Adventures of Dizzy, The (Europe) (En,Fr,De) (Unl)=디지의 환타스틱 모험
Fantastic Adventures of Dizzy, The (USA) (Aladdin Compact Cartridge) (Unl)=디지의 환타스틱 모험 (알라딘 컴팩트 카트리지)(해적판)
Fantastic Adventures of Dizzy, The (USA) (Unl)=디지의 환타스틱 모험 (해적판)
Fantasy Zone (Japan) (Sunsoft)=판타지 존
Fantasy Zone (USA) (Tengen) (Unl)=판타지 존
Fantasy Zone II - Opa-Opa no Namida (Japan)=판타지 존 2 - 오파오파의 눈물
Faria - A World of Mystery & Danger! (USA)=파리아 - 월드 미스터리 데인져!
Faria - Fuuin no Tsurugi (Japan)=파리아 - 봉인의 검 (일본판)
Faxanadu (Europe)=팩서너두
Faxanadu (Japan)=팩서너두 (일본판)
Faxanadu (USA) (Rev 1)=팩서너두 (개정판 1)
Faxanadu (USA)=팩서너두
FC Genjin - Freakthoropus Computerus (Japan)=FC 원인 (일본판)
Felix the Cat (Europe)=펠릭스
Felix the Cat (USA)=펠릭스
Feng Shen Bang (Asia) (Ja) (Unl)=봉신방
Ferrari (Japan)=페라리 (일본판)
Ferrari Grand Prix Challenge (Europe)=페라리 그랑프리 챌린지
Ferrari Grand Prix Challenge (USA)=페라리 그랑프리 챌린지
Fester's Quest (Europe) (Rev 1)=페스터스 퀘스트
Fester's Quest (Europe)=페스터스 퀘스트 (유럽판)
Fester's Quest (USA)=페스터스 퀘스트
Field Combat (Japan)=필드 컴뱃
Fighting Golf (Japan)=파이팅 골프 (일본판)
Fighting Hero (Asia) (Ja) (Unl)=파이팅 히어로
Fighting Hero III (Asia) (Ja) (Unl)=파이팅 히어로 3
Fighting Road (Japan)=파이팅 로드
Final Combat (Asia) (Ja) (NTSC) (Unl)=파이널 컴뱃
Final Combat (Asia) (Ja) (PAL) (Unl)=파이널 컴뱃 (아시아판)(일본어)(PAL)(해적판)
Final Fantasy (Japan) (Rev 1) (3DS Virtual Console)=파이널 판타지 (일본판)(개정판 1)
Final Fantasy (Japan) (Rev 1) (Wii and Wii U Virtual Console)=파이널 판타지 (일본판)(개정판 1)
Final Fantasy (Japan) (Rev 1)=파이널 판타지 (일본판)(개정판 1)
Final Fantasy (Japan)=파이널 판타지 (일본판)
Final Fantasy (USA) (Virtual Console)=파이널 판타지 (버추얼 콘솔)
Final Fantasy (USA)=파이널 판타지
Final Fantasy I, II (Japan)=파이널 판타지 1,2 합팩
Final Fantasy II (Japan) (3DS Virtual Console)=파이널 판타지 2 (일본판)
Final Fantasy II (Japan) (Wii and Wii U Virtual Console)=파이널 판타지 2 (일본판)
Final Fantasy II (Japan)=파이널 판타지 2
Final Fantasy II (USA) (Proto)=파이널 판타지 2 (시험판)
Final Fantasy III (Japan) (3DS Virtual Console)=파이널 판타지 3 (일본판)
Final Fantasy III (Japan) (Wii U Virtual Console)=파이널 판타지 3 (일본판)(Wii U 버추얼 콘솔)
Final Fantasy III (Japan) (Wii Virtual Console)=파이널 판타지 3 (일본판)(Wii 버추얼 콘솔)
Final Fantasy III (Japan)=파이널 판타지 3
Final Lap (Japan)=파이널 랩
Final Mission (Japan)=파이널 미션 (일본판)
Fire 'n Ice (USA)=화이어 앤 아이스
Fire Dragon (Asia) (En) (Unl)=파이어 드래곤
Fire Emblem - Ankoku Ryuu to Hikari no Tsurugi (Japan)=파이어 엠블럼 - 암흑 용과 빛의 검
Fire Emblem Gaiden (Japan) (Virtual Console)=파이어 엠블렘 외전 (일본판)(버추얼 콘솔)
Fire Emblem Gaiden (Japan)=파이어 엠블렘 외전
Firehawk (Europe) (Unl)=파이어호크
Firehawk (USA) (Unl)=파이어호크 (해적판)
Fisher-Price - Firehouse Rescue (USA)=피셔프라이스 - 파이어하우스 레스큐
Fisher-Price - I Can Remember (USA)=피셔프라이스 - 아이 캔 리멤버
Fisher-Price - Perfect Fit (USA)=피셔프라이스 - 퍼펙트 핏
Fist of the North Star (USA)=북두의 권
Flappy (Japan)=플로피
Fleet Commander (Japan)=플릿 커맨더
Flight of the Intruder (USA)=플라이트 오브 더 인트루더
Flintstones, The - The Rescue of Dino & Hoppy (Europe)=고인돌 가족 플린스톤 - 디노 & 호피 구조
Flintstones, The - The Rescue of Dino & Hoppy (Japan)=고인돌 가족 플린스톤 - 디노 & 호피 구조 (일본판)
Flintstones, The - The Rescue of Dino & Hoppy (USA)=고인돌 가족 플린스톤 - 디노 & 호피 구조
Flintstones, The - The Surprise at Dinosaur Peak (Europe)=고인돌 가족 플린스톤 - 디노사우르스 봉우리에서 기습
Flintstones, The - The Surprise at Dinosaur Peak! (USA)=고인돌 가족 플린스톤 - 디노사우르스 봉우리에서 기습
Flipull - An Exciting Cube Game (Japan) (En) (Rev 1)=플립폴 - 재밌는 상자 게임
Flipull - An Exciting Cube Game (Japan) (En)=플립폴 - 재밌는 상자 게임 (일본판)(영어)
Flying Dragon - The Secret Scroll (USA)=플라잉 드래곤 - 비밀문서
Flying Hero (Japan)=날으는 영웅
Flying Warriors (USA) (Beta)=플라잉 워리어스 (베타)
Flying Warriors (USA) (Virtual Console)=플라잉 워리어스 (버추얼 콘솔)
Flying Warriors (USA)=플라잉 워리어스
Formation Z (Japan) (Rev A) (Virtual Console)=포메이션 Z (일본판)(개정판 A)(버추얼 콘솔)
Formation Z (Japan) (Rev A)=포메이션 Z
Formation Z (Japan)=포메이션 Z (일본판)
Formula 1 Sensation (Europe)=포뮬러 1 센세이션
Formula One - Built to Win (USA)=포뮬라 원 - 빌트 투 윈
Four Players' Tennis (Europe)=포 플레이어스 테니스
Fox's Peter Pan & the Pirates - The Revenge of Captain Hook (USA)=폭스의 피터팬과 해적들 - 후크선장의 복수
Frankenstein - The Monster Returns (USA)=프랑켄스타인 - 몬스터 귀환
Free Fall (USA) (Proto)=프리 폴
Freedom Force (USA)=프리덤 포스
Friday the 13th (USA)=13일의 금요일
Front Line (Japan)=프론트 라인
Fudou Myouou Den (Japan)=부동 명왕 전 (일본판)
Fun House (USA)=펀 하우스
Funblaster Pak (Australia) (Unl)=펀블래스터 팩
Fushigi na Blobby - Blobania no Kiki (Japan)=이상한 블로비 - 블로바니아의 위기 (일본판)
Fushigi no Umi no Nadia (Japan)=이상한 바다의 나디아
Futebol (Brazil) (Unl)=풋볼 (브라질판)(해적판)
Future Wars - Mirai Senshi Lios (Japan)=미래전자 라이오스
Fuzzical Fighter (Japan)=퍼지컬 파이터
G.I. Joe - A Real American Hero (USA)=G.I. 조 - 진정한 미국의 영웅
G.I. Joe - A Real American Hero - The Atlantis Factor (USA) (Beta)=G.I. 조 - 진정한 미국의 영웅 - 아틀란티스 팩터 (베타)
G.I. Joe - The Atlantis Factor (USA)=G.I. 조 - 아틀란티스 팩터
Gaiapolis (Asia) (Ja) (Unl)=가이아폴리스
Galactic Crusader (Asia) (Ja) (Unl)=겔럭틱 크루세이더 (아시아판)(일본어)(해적판)
Galactic Crusader (USA) (Unl)=겔럭틱 크루세이더
Galaga (Europe)=갤러그
Galaga (Japan)=갤러그 (일본판)
Galaga (World) (Namcot Collection, Namco Museum Archives Vol 2)=갤러그 (세계판)
Galaga - Demons of Death (USA)=갤러그 - 디몬 오브 데스
Galaxian (Japan) (Rev A)=갤럭시안
Galaxian (Japan)=갤럭시안 (일본판)
Galaxian (World) (Namcot Collection, Namco Museum Archives Vol 1)=갤럭시안 (세계판)
Galaxy 5000 - Racing in the 51st Century (Europe)=갤럭시 5000
Galaxy 5000 - Racing in the 51st Century (USA)=갤럭시 5000
Gambler Jiko Chuushinha (Japan)=겜블러 자기 중심파
Gambler Jiko Chuushinha 2 (Japan)=겜블러 자기 중심파 2
Game Designer Yousei Soft - Dezaemon (Japan)=게임 디자이너 양성 소프트 - 회묘위문
Game Genie (USA) (Unl)=게임 지니
Game Master Kid (Unknown) (Proto) (RAM) (Unl)=게임 마스터 키드
Game Master Kid (Unknown) (Proto) (Unl)=게임 마스터 키드 (불명)(시험판)(해적판)
Game Party (Japan)=게임 파티
Ganbare Goemon 2 (Japan) (Virtual Console)=힘내라 고에몽2 (일본판)(버추얼 콘솔)
Ganbare Goemon 2 (Japan)=힘내라 고에몽2
Ganbare Goemon Gaiden - Kieta Ougon Kiseru (Japan) (Rev 1) (Virtual Console)=힘내라 고에몽 외전 - 사라진 황금 담뱃대 (일본판)(개정판 1)(버추얼 콘솔)
Ganbare Goemon Gaiden - Kieta Ougon Kiseru (Japan) (Rev 1)=힘내라 고에몽 외전 - 사라진 황금 담뱃대
Ganbare Goemon Gaiden - Kieta Ougon Kiseru (Japan)=힘내라 고에몽 외전 - 사라진 황금 담뱃대 (일본판)
Ganbare Goemon Gaiden 2 - Tenka no Zaihou (Japan)=힘내라 고에몽 외전 2 - 천하의 재보
Ganbare Goemon! - Karakuri Douchuu (Japan) (Virtual Console)=힘내라 고에몽 - 꼭두각시 여행길 (일본판)(버추얼 콘솔)
Ganbare Goemon! - Karakuri Douchuu (Japan)=힘내라 고에몽 - 꼭두각시 여행길
Ganbare Pennant Race! (Japan)=힘내라 페넌트 레이스!
Ganso Saiyuuki - Super Monkey Daibouken (Japan)=원조 서유기 - 슈퍼 몽키 대모험
Gaplus (World) (Namcot Collection, Namco Museum Archives Vol 2) (Aftermarket)=가플러스
Gardman (Asia) (Unl)=가드맨
Garfield no Isshukan (Japan) (Beta 1)=가필드의 일주일 (일본판)(배타 1)
Garfield no Isshukan (Japan) (Beta 2)=가필드의 일주일 (일본판)(베타 2)
Garfield no Isshukan (Japan)=가필드의 일주일
Gargoyle's Quest II (Europe)=가고일스 퀘스트 2
Gargoyle's Quest II (USA)=가고일스 퀘스트 2
Garry Kitchen's Battletank (USA)=개리 키친의 탱크배틀
Gauntlet (USA) (Unl)=건틀렛 (해적판)
Gauntlet (USA)=건틀렛
Gauntlet II (Europe)=건틀렛 2
Gauntlet II (USA)=건틀렛 2
Gegege no Kitarou - Youkai Daimakyou (Japan) (Beta)=게게게의 귀태랑 - 요괴 대마경 (일본판)(베타)
Gegege no Kitarou - Youkai Daimakyou (Japan)=게게게의 귀태랑 - 요괴 대마경 (일본판)
Gegege no Kitarou 2 - Youkai Gundan no Chousen (Japan)=게게게의 귀태랑 2 - 요괴 군단 의 도전
Geimos (Japan)=게이모스
Gekikame Ninja Den (Japan) (Virtual Console)=격귀 닌자전 (일본판)(버추얼 콘솔)
Gekikame Ninja Den (Japan)=격귀 닌자전 (일본판)
Gekitotsu Yonku Battle (Japan)=격돌 사구 배틀
Gekitou Pro Wrestling!! - Toukon Densetsu (Japan)=격투 프로 레슬링 - 투혼 전설 (일본판)
Gekitou Stadium!! (Japan)=격투 스타디움!! (일본판)
Gemfire (USA)=젬파이어
Genghis Khan (USA)=징기스칸
Genpei Touma Den - Computer Boardgame (Japan)=원평토마전 - 컴퓨터 보드게임
George Foreman's KO Boxing (Europe)=조지 포먼의 KO 복싱
George Foreman's KO Boxing (USA)=조지 포먼의 KO 복싱
Getsu Fuuma Den (Japan) (Virtual Console)=월풍마전 (일본판)(버추얼 콘솔)
Getsu Fuuma Den (Japan)=월풍마전
Ghost Lion (USA)=고스트 라이온
Ghost'n Goblins (Europe)=마계촌 / 고스트 앤 고블린
Ghostbusters (Japan) (Beta)=고스트 버스터즈 (일본판)(베타)
Ghostbusters (Japan)=고스트 버스터즈 (일본판)
Ghostbusters (USA)=고스트 버스터즈
Ghostbusters II (Europe)=고스트 바스터즈 2
Ghostbusters II (USA)=고스트 바스터즈 2
Ghosts'n Goblins (USA)=마계촌 / 고스트 앤 고블린
Ghoul School (USA)=굴 스쿨
Gimmi a Break - Shijou Saikyou no Quiz Ou Ketteisen (Japan)=기미 어 브레이크 - 사상 최강의 퀴즈왕결정전
Gimmi a Break - Shijou Saikyou no Quiz Ou Ketteisen 2 (Japan)=기미 어 브레이크 - 사상 최강의 퀴즈왕결정전 2
Gimmick! (Japan) (Beta)=기믹! (일본판)(베타)
Gimmick! (Japan)=기믹! (일본판)
Ginga Eiyuu Densetsu (Japan)=은하영웅전설
Ginga no Sannin (Japan)=은하의 3인
Gluk the Thunder Warrior (Spain) (Gluk Video) (Unl)=글럭 더 썬더 워리어 (스페인판)(글럭 비디오)(해적판)
Go! Benny! (Asia) (En) (Unl)=고!배니!
Goal! (Europe)=골! 골! 골!
Goal! (USA)=골! 골! 골!
Goal! Two (USA)=골! 2
Goal!! (Japan)=골!! (일본판)
God Slayer - Haruka Tenkuu no Sonata (Japan) (SNK 40th Anniversary Collection)=갓 슬레이어 - 아득한 천공의 소나타 (일본판)
God Slayer - Haruka Tenkuu no Sonata (Japan)=갓 슬레이어 - 아득한 천공의 소나타 (일본판)
Godzilla - Monster of Monsters! (Europe)=고질라 - 괴물들 중 괴물
Godzilla - Monster of Monsters! (USA)=고질라 - 괴물들 중 괴물
Godzilla 2 - War of the Monsters (USA)=고질라 2 - 몬스터들의 전쟁
Gojira (Japan)=고질라 (일본판)
Golf '92, The (Japan)=골프 92
Golf (Europe) (GameCube Edition)=골프 (유럽판)(게임큐브 버전)
Golf (Europe)=골프
Golf (Japan) (En) (GameCube Edition)=골프 (일본판)(영어)(게임큐브 버전)
Golf (Japan) (En)=골프 (일본판)(영어)
Golf (USA)=골프
Golf Club - Birdy Rush (Japan)=골프 클럽 - 버디 러쉬
Golf Grand Slam (Japan)=골프 그랜드 슬램 (일본판)
Golf Grand Slam (USA)=골프 그랜드 슬램
Golfkko Open (Japan)=골프코 오픈
Golgo 13 - Daiisshou - Kamigami no Tasogare (Japan)=고르고 13 - 제1장 - 신들의 황혼 (일본판)
Golgo 13 - Dainishou - Icarus no Nazo (Japan)=고르고 13 - 제2장 - 이카루스의 수수께끼 (일본판)
Golgo 13 - Top Secret Episode (USA)=고르고 13 - 탑 시크릿 에피소드
Gomoku Narabe (Japan) (GameCube Edition)=오목 (일본판)(게임큐브 버전)
Gomoku Narabe (Japan)=오목
Goonies (Japan)=구니스
Goonies 2 - Fratelli Saigo no Chousen (Japan)=구니스 2 - 프라텔리 최후의 도전 (일본판)
Goonies II, The (Europe)=구니스 2
Goonies II, The (USA)=구니스 2
Goonies II, The - Fratelli Saigo no Chousen (Japan) (Sample)=구니스 2 - 프라텔리 최후의 도전 (일본판)(샘플)
Gorby no Pipeline Daisakusen (Japan)=고르비의 파이프라인 대작전
Gorilla Man, The (Japan)=고릴라 맨
Gotcha! - The Sport! (USA)=갓챠! - 스포츠
Gozonji - Yaji Kita Chin Douchuu (Japan)=고존지 - 즐거운 여행길
Gradius (Europe)=그라디우스
Gradius (Japan) (ArchiMENdes Hen)=그라디우스 (일본판)(ArchiMENdes Hen)
Gradius (Japan)=그라디우스 (일본판)
Gradius (USA)=그라디우스
Gradius II (Japan)=그라디우스 2
Gran Aventura Submarina, La (Spain) (Gluk Video) (Unl)=그레이트 해저 모험
Grand Master (Japan)=그랜드 마스터
Great Battle Cyber (Japan)=그레이트 배틀 사이버
Great Boxing - Rush Up (Japan)=그레이트 복싱 - 러쉬 업 (일본판)
Great Deal (Japan)=그레이트 딜
Great Tank (Japan) (SNK 40th Anniversary Collection)=그레이트 탱크 (일본판)
Great Tank (Japan)=그레이트 탱크 (일본판)
Great Waldo Search, The (USA)=그레이트 윌도 서치
Great Wall, The (Asia) (Ja) (PAL) (Unl)=만리장성
Greg Norman's Golf Power (USA)=그렉 노먼의 골프 파워
Gremlin 2 - Shinshu Tanjou (Japan)=그렘린 2 - 신종탄생 (일본판)
Gremlins 2 - The New Batch (Europe) (Beta)=그렘린 2 - 신종탄생 (유럽판)(베타)
Gremlins 2 - The New Batch (Europe)=그렘린 2 - 신종탄생
Gremlins 2 - The New Batch (USA) (Beta)=그렘린 2 - 신종탄생 (베타)
Gremlins 2 - The New Batch (USA)=그렘린 2 - 신종탄생
Guardian Legend, The (Europe)=가디언 전설
Guardian Legend, The (USA)=가디언 전설
Guardic Gaiden (Japan)=가디크 외전 (일본판)
Guerrilla War (Europe)=게릴라 워
Guerrilla War (USA)=게릴라 워
Guevara (Japan)=게바라 (일본판)
Gumshoe (USA, Europe)=검슈
Gun Nac (Japan)=건 낙 (일본판)
Gun Nac (USA)=건 낙
Gun Sight (Japan)=건 사이트 (일본판)
Gun-Dec (Japan)=건 덱 (일본판)
Gun.Smoke (Europe)=건 스모크
Gun.Smoke (USA)=건 스모크
Gunhed - Aratanaru Tatakai (Japan)=건헤드 - 새로운 싸움
Gyrodine (Japan)=자이로다인
Gyromite ~ Gyro (World)=자이로마이트
Gyruss (USA)=자이러스
Haja no Fuuin (Japan)=패사의 봉인
Hammerin' Harry (Europe)=목수 겐씨 / 해머링 해리 / 망치소년
Hana no Star Kaidou (Japan)=꽃의 스타 가도
Hanafuda Yuukyou Den - Nagarebana Oryuu (Japan) (Unl)=화투 유흥전 - 흐르는 꽃
Hanjuku Hero (Japan) (Virtual Console)=반숙 영웅 (일본판)(버추얼 콘솔)
Hanjuku Hero (Japan)=반숙 영웅
Happily Ever After starring Snow White (USA) (Proto)=백설공주의 오래오래 행복하게
Happy Birthday Bugs (Japan)=해피 버스데이 벅스 (일본판)
Happy Camper (USA) (Proto) (Unl) [b]=해피 캠퍼
Happy Pairs (Asia) (Ja) (PAL) (Unl)=해피 페어
Hard Drivin' (USA) (Proto) (Unl)=하드 드라이빙
Harlem Globetrotters (USA)=할렘 글로베트로터스
Hatris (Japan)=햇트리스 (일본판)
Hatris (USA)=햇트리스
Hayauchi Super Igo (Japan) (Rev 1)=하야우치 슈퍼 바둑
Hayauchi Super Igo (Japan)=하야우치 슈퍼 바둑 (일본판)
Heavy Barrel (Japan)=헤비 배럴 (일본판)
Heavy Barrel (USA)=헤비 배럴
Heavy Shreddin' (USA)=헤비 슈레딩
Hebereke (Japan) (Virtual Console)=헤베레케 (일본판)(버추얼 콘솔)
Hebereke (Japan)=헤베레케 (일본판)
Hector '87 (Japan)=헥터 87 (일본판)
Heisei Tensai Bakabon (Japan)=헤이세이 천재 바카본
Hell Fighter (Asia) (Ja) (PAL) (Unl)=헬 파이터
Hello Kitty no Ohanabatake (Japan)=헬로 키티의 정원
Hello Kitty World (Japan)=헬로 키티 월드
Heracles no Eikou - Toujin Makyou Den (Japan)=헤라클레스의 영광 - 투인 마경전
Heracles no Eikou II - Titan no Metsubou (Japan)=헤라클레스의 영광 2 - 타이탄의 멸망
HeroQuest (Europe) (Proto) (1992-08-21)=히어로퀘스트
HeroQuest (USA) (Proto)=히어로퀘스트 (시험판)
HES 6-Pak - Real Player's Pak (Australia) (Unl)=HES 6팩 - 리얼 플레이어 팩 (호주판)(해적판)
Hidden Chinese Chess - An Qi (Asia) (Ja) (NTSC) (Unl)=암기
Higemaru - Makai-jima - Nanatsu no Shima Daibouken (Japan)=히게마루 마계도 - 일곱섬의 대모험
High Speed (Europe)=하이스피드
High Speed (USA)=하이스피드
Highway Star (Japan)=하이웨이 스타 (일본판)
Hikari no Senshi Foton - The Ultimate Game on Planet Earth (Japan)=빛의 전사 포톤 - 행성 졸디아스의 전투
Hino Tori - Houou Hen - Gaou no Bouken (Japan)=불새 - 봉황편 - 아왕의 모험
Hirake! Ponkikki (Japan)=열려라! 폰포키
Hiryuu no Ken - Ougi no Sho (Japan)=비룡의 권 - 오의의 서 (일본판)
Hiryuu no Ken II - Dragon no Tsubasa (Japan) (Virtual Console)=비룡의 권 2 - 용의 날개 (일본판)(버추얼 콘솔)
Hiryuu no Ken II - Dragon no Tsubasa (Japan)=비룡의 권 2 - 용의 날개
Hiryuu no Ken III - 5 Nin no Dragon (Japan)=비룡의 권 3 - 5인의 용
Hiryuu no Ken Special - Fighting Wars (Japan) (Beta)=비룡의 권 스페셜 - 파이팅 워즈 (일본판)(베타)
Hiryuu no Ken Special - Fighting Wars (Japan)=비룡의 권 스페셜 - 파이팅 워즈
Hissatsu Doujou Yaburi (Japan)=필살 도장파괴
Hissatsu Shigoto Nin (Japan)=필살 사업인
Hit Marmot (Asia) (Ja) (Unl)=힛 마못
Hit the Ice (USA) (Proto)=힛 더 아이스
Hitler no Fukkatsu - Top Secret (Japan) (Beta)=히틀러의 부활 - 탑 시크릿 (일본판)(베타)
Hitler no Fukkatsu - Top Secret (Japan)=히틀러의 부활 - 탑 시크릿 (일본판)
Hogan's Alley (World)=호건스 앨리
Hokkaidou Rensa Satsujin - Okhotsk ni Kiyu (Japan)=오츠크에 사라지다 - 훗카이도 연쇄살인
Hokuto no Ken (Japan) (Beta)=북두의 권 (일본판)(베타)
Hokuto no Ken (Japan)=북두의 권
Hokuto no Ken 2 (Japan)=북두의 권 2 (일본판)
Hokuto no Ken 3 - Shin Seiki Souzou Seiken Retsuden (Japan)=북두의 권 3 - 신세기창조 처권열전
Hokuto no Ken 4 - Shichisei Haken Den - Hokuto Shinken no Kanata e (Japan)=북두의 권 4 - 칠성패권전 - 북두신권 저멀리
Hollywood Squares (USA)=헐리우드 스퀘어
Holy Diver (Japan)=홀리 다이버
Home Alone (USA) (Rev 1)=나홀로 집에
Home Alone (USA)=나홀로 집에
Home Alone 2 - Lost in New York (Europe)=나홀로 집에 2 - 로스트인 유욕
Home Alone 2 - Lost in New York (USA)=나홀로 집에 2 - 로스트인 유욕
Honey Peach (Asia) (Ja) (Unl)=허니 피치
Honoo no Toukyuuji - Dodge Danpei (Japan)=피구왕 통키
Honoo no Toukyuuji - Dodge Danpei 2 (Japan)=피구왕 통키 2
Honshougi - Naitou 9 Dan Shougi Hiden (Japan)=본장기 - 나이토 9단 장기비전
Hook (Europe)=후크
Hook (Japan)=후크 (일본판)
Hook (USA)=후크
Hoops (Europe)=후프
Hoops (USA)=후프
Hoshi no Kirby - Yume no Izumi no Monogatari (Japan)=별의 커비 - 꿈의샘 이야기 (일본판)
Hoshi o Miru Hito (Japan)=별을 보는 사람
Hostages - The Embassy Mission (Japan)=인질 - 대사관 미션 (일본판)
Hot Slots (Asia) (Ja) (Unl)=핫 슬롯 (아시아판)(일본어)(해적판)
Hototogisu (Japan)=호토토기스
Hottarman no Chitei Tanken (Japan) (Beta)=홋타맨의 지저 탐험 (일본판)(베타)
Hottarman no Chitei Tanken (Japan)=홋타맨의 지저 탐험
Huang Di (Asia) (Ja) (Unl)=황제
Hudson Hawk (Europe)=허드슨 호크
Hudson Hawk (Japan)=허드슨 호크 (일본판)
Hudson Hawk (USA)=허드슨 호크
Huge Insect (Asia) (Ja) (Unl)=휴지 인섹트
Hunt for Red October, The (Europe)=붉은 10월
Hunt for Red October, The (USA) (Rev 1)=붉은 10월 (개정판 1)
Hunt for Red October, The (USA)=붉은 10월
HVC Kensa Cassette Controller Test (Japan) (Test Program)=HVC 카세트 컨트롤러 테스트
Hyakkiyagyou (Japan)=백귀야행
Hyaku no Sekai no Monogatari - The Tales on a Watery Wilderness (Japan)=백의 세계의 이야기
Hydlide (USA)=하드라이드
Hydlide 3 - Yami kara no Houmonsha (Japan)=하이드라이드 3 - 어둠으로부터의 방문자
Hydlide Special (Japan)=하이드라이드 스페셜 (일본판)
Hyokkori Hyoutan-jima - Nazo no Kaizokusen (Japan)=뜻밖의 표주박섬 - 수수께끼의 해적전
Hyper Olympic (Japan) (Genteiban!)=하이퍼 올림픽 (일본판)(한정판)
Hyper Olympic (Japan)=하이퍼 올림픽 (일본판)
Hyper Sports (Japan) (Rev 1)=하이퍼 스포츠
Hyper Sports (Japan)=하이퍼 스포츠 (일본판)
I Love Softball (Japan)=아이 러브 소프트볼
Ice Climber (Japan) (En)=아이스 클라이머 (일본판)(영어)
Ice Climber (USA, Europe, Korea)=아이스 클라이머
Ice Hockey (Europe) (Virtual Console)=아이스 하키 (유럽판)(버추얼 콘솔)
Ice Hockey (Europe)=아이스 하키
Ice Hockey (USA)=아이스 하키
Ide Yousuke Meijin no Jissen Mahjong (Japan) (Rev 1)=이데 요스케 명인의 실전마작
Ide Yousuke Meijin no Jissen Mahjong (Japan)=이데 요스케 명인의 실전마작 (일본판)
Ide Yousuke Meijin no Jissen Mahjong II (Japan)=이데 요스케 명인의 실전마작 2
Idemitsu - Space College - Kikenbutsu no Yasashii Butsuri to Kagaku (Japan)=위험물의 부드러운 물리와 과학
Idol Hakkenden (Japan)=아이돌 팔견전
Idol Shisen Mahjong (Japan) (Unl)=아이돌 실전 마작 (일본판)(해적판)
Igo - Kyuu Roban Taikyoku (Japan)=바둑 - 구노반대국
Igo Meikan (Japan)=바둑 명감
Igo Shinan '91 (Japan)=바둑 지남 91
Igo Shinan '92 (Japan)=바둑 지남 92
Igo Shinan '93 (Japan)=바둑 지남 93
Igo Shinan '94 (Japan)=바둑 지남 94
Igo Shinan (Japan)=바둑 지남
Ikari (Japan)=이카리 (일본판)
Ikari II - Dogosoken (Japan)=이카리 2 - 도고소켄 (일본판)
Ikari III (Japan)=이카리 3 (일본판)
Ikari III - The Rescue (USA)=이카리 3 - 구출
Ikari Warriors (Europe)=이카리
Ikari Warriors (USA) (Rev 1)=이카리 (개정판 1)
Ikari Warriors (USA)=이카리
Ikari Warriors II - Victory Road (USA)=이카리 2 - 빅토리 로드
Ike Ike! Nekketsu Hockey-bu - Subette Koronde Dairantou (Japan)=가라 가라! 열혈 하키부 - 미끄러지고 넘어지는 대난투
Ikinari Musician (Japan) (Beta)=갑자기 뮤지션 (일본판)(베타)
Ikinari Musician (Japan)=갑자기 뮤지션
Ikki (Japan)=잇키
Image Fight (Japan)=이미지 파이트 (일본판)
Image Fight (USA)=이미지 파이트
Immortal, The (USA)=임모탈
Impossible Mission II (USA) (Unl)=임파서블 미션 2
Incantation (Asia) (Ja) (Unl)=인캔테이션 (아시아판)(일본어)(해적판)
Incredible Crash Dummies, The (Europe)=인크레더블 크래지 더미
Incredible Crash Dummies, The (USA)=인크레더블 크래지 더미
Indiana Jones and the Last Crusade (Europe)=인디아나 존스와 최후의 성전
Indiana Jones and the Last Crusade (USA) (Taito)=인디아나 존스와 최후의 성전
Indiana Jones and the Last Crusade (USA) (UBI Soft)=인디아나 존스와 최후의 성전 (UBI 소프트)
Indiana Jones and the Temple of Doom (USA) (Rev 1)=인디아나 존스와 저주의 사원
Indiana Jones and the Temple of Doom (USA) (Unl)=인디아나 존스와 저주의 사원 (해적판)
Indiana Jones and the Temple of Doom (USA)=인디아나 존스와 저주의 사원
Indora no Hikari (Japan)=인도라의 빛
Infiltrator (USA)=인펄트레이터
Insector X (Japan)=인섹터 X
International Cricket (Australia) (Beta) (1992-08-24)=인터네셔널 크리켓 (호주판)(베타)
International Cricket (Australia)=인터네셔널 크리켓
Iron Tank - The Invasion of Normandy (Europe)=아이언 탱크 - 노르망디 공격
Iron Tank - The Invasion of Normandy (USA)=아이언 탱크 - 노르망디 공격
IronSword - Wizards & Warriors II (Europe)=아이언 소드 - 위자드 & 워리어 2
IronSword - Wizards & Warriors II (USA)=아이언 소드 - 위자드 & 워리어 2
Isaki Shuugorou no Keiba Hisshou Gaku (Japan)=이사키수고로의 경마 필승학
Ishin no Arashi (Japan)=유신의 폭풍우
Isolated Warrior (Europe)=아이솔레이티드 워리어
Isolated Warrior (USA)=아이솔레이티드 워리어
Itadaki Street - Watashi no Omise ni Yottette (Japan)=이타다키 스트리트 - 내 가게에 들려
Ivan 'Ironman' Stewart's Super Off Road (Europe)=이반 아이언맨 스튜어트의 슈퍼 오프로드
Ivan 'Ironman' Stewart's Super Off Road (USA)=이반 아이언맨 스튜어트의 슈퍼 오프로드
J.League Fighting Soccer - The King of Ace Strikers (Japan)=J리그 파이팅 사커 - 킹 오브 에이스 스트라이커
J.League Winning Goal (Japan)=J리그 위닝 골
Jack Nicklaus' Greatest 18 Holes of Major Championship Golf (Europe)=잭 니콜라우스의 위대한 18홀
Jack Nicklaus' Greatest 18 Holes of Major Championship Golf (USA)=잭 니콜라우스의 위대한 18홀
Jackal (USA)=특수부대 자칼 / 자칼
Jackie Chan (Japan)=성룡의 액션 쿵후 (일본판)
Jackie Chan's Action Kung Fu (Europe)=성룡의 액션 쿵후
Jackie Chan's Action Kung Fu (USA)=성룡의 액션 쿵후
Jackpot (Australia) (Unl)=잭팟
Jajamaru Gekimaden - Maboroshi no Kinmajou (Japan)=자자마루 격마전 - 환상의 금마섬
Jajamaru Ninpou Chou (Japan)=자자마루 인법 장
Jajamaru no Daibouken (Japan)=자자마루의 대모험
James Bond Jr (Europe)=제임스 본드 주니어
James Bond Jr (USA)=제임스 본드 주니어
Janggun-ui Adeul (Korea) (Unl)=장군의 아들
Jangou (Japan)=작호
Jarinko Chie - Bakudan Musume no Shiawase Sagashi (Japan)=자린코 치에 - 파쿠단 딸의 행운
Jaws (USA)=죠스
Jekyll Hakase no Houma ga Toki (Japan)=지킬박사 (일본판)
Jeopardy! (USA) (Rev 1)=제퍼디!
Jeopardy! (USA)=제퍼디!
Jeopardy! 25th Anniversary Edition (USA)=재퍼디! 25주년 에디션
Jeopardy! Junior Edition (USA)=재퍼디! 쥬니어 에디션
Jesus - Kyoufu no Bio Monster (Japan)=지저스 - 공포의 바이오 몬스터
Jetsons, The - Cogswell's Caper (Europe)=우주 가족 젯슨 - 콕스웰의 난동
Jetsons, The - Cogswell's Caper (Japan)=우주 가족 젯슨 - 콕스웰의 난동 (일본판)
Jetsons, The - Cogswell's Caper (USA)=우주 가족 젯슨 - 콕스웰의 난동
Jigoku Gokuraku Maru (Japan)=지옥극락환 (일본판)
Jikuu Yuuden - Debias (Japan)=시공용전 - 데비아스
Jimmy Connors Tennis (Europe)=지미 코너의 테니스
Jimmy Connors Tennis (USA)=지미 코너의 테니스
JJ (Japan)=JJ
Joe & Mac (USA)=조 & 맥
Joe & Mac - Caveman Ninja (Europe)=조 & 맥 - 케이브맨 닌자
John Elway's Quarterback (USA)=존 엘웨이의 쿼터 백
Jongbou (Japan)=종부
Jordan vs Bird - One on One (USA)=조단 대 버드
Joshua & the Battle of Jericho (USA) (v5.0) (Unl)=여호수아 & 여리고 성벽 전투 (v5.0)(해적판)
Joshua & the Battle of Jericho (USA) (v6.0) (Unl)=여호수아 & 여리고 성벽 전투
Journey to Silius (Europe)=저니 투 실리우스
Journey to Silius (USA)=저니 투 실리우스
Journey to the West (Asia) (Ja) (Unl)=서유기 - 서역으로의 여행
Joust (Japan)=자우스트 (일본판)
Joust (USA)=자우스트
Jovial Race (Asia) (En) (Unl)=미혼차 (아시아판)(영어)(해적판)
Jovial Race (Asia) (Ja) (PAL) (Unl)=미혼차
Joy Mech Fight (Japan) (Virtual Console)=조이 메카 파이트 (일본판)(버추얼 콘솔)
Joy Mech Fight (Japan)=조이 메카 파이트
JuJu Densetsu (Japan)=주주 전설 (일본판)
Jumbo Ozaki no Hole in One Professional (Japan)=점보 오자키의 홀인원 프로페셔널
Jumpin' Kid - Jack to Mame no Ki Monogatari (Japan)=점핀 키드 - 잭 과 콩나무 이야기
Jungle Book, The (Europe)=정글북
Jungle Book, The (USA)=정글북
Jurassic Boy (Asia) (Ja) (Unl)=쥬라기 보이
Jurassic Park (Europe)=쥬라기 공원
Jurassic Park (USA)=쥬라기 공원
Just Breed (Japan)=저스트 브리드
Juuouki (Japan)=수왕기
Juuryoku Soukou Metal Storm (Japan)=중력 장갑 메탈 스톰 (일본판)
Juvei Quest (Japan) (Alt)=쥬베이 퀘스트 (일본판)(대체)
Juvei Quest (Japan)=쥬베이 퀘스트
Kabuki - Quantum Fighter (Europe)=가부키 - 퀀텀 파이터
Kabuki - Quantum Fighter (USA)=가부키 - 퀀텀 파이터
Kabushiki Doujou (Japan)=주식 도장
Kaettekita! Gunjin Shougi - Nanya Sore! (Japan)=돌아왔다! 군인장기 - 뭐야 그거!
Kage no Densetsu (Japan) (Virtual Console)=카게의 전설 (일본판)(버추얼 콘솔)
Kage no Densetsu (Japan)=카게의 전설 (일본판)
Kagerou Densetsu (Japan)=영랑전설
Kaguya Hime Densetsu (Japan)=카구야 공주 전설
Kaijuu Monogatari (Japan) (Namcot Collection)=괴수 이야기 (일본판)
Kaijuu Monogatari (Japan)=괴수 이야기
Kaiketsu Yancha Maru (Japan)=쾌걸 얀차마루 (일본판)
Kaiketsu Yancha Maru 2 - Karakuri Land (Japan)=쾌걸 얀차마루 2 - 가라쿠리 랜드
Kaiketsu Yancha Maru 3 - Taiketsu! Zouringen (Japan)=쾌걸 얀차마루 3 - 대결! 졸링겐
Kakefu-kun no Jump Tengoku - Speed Jigoku (Japan)=카케후군의 점프 천국 - 스피드 지옥 (일본판)
Kame no Ongaeshi - Urashima Densetsu (Japan)=거북이의 보은 - 우라시마 전설 (일본판)
Kamen no Ninja - Akakage (Japan)=가면의 닌자 - 아카카게
Kamen no Ninja - Hanamaru (Japan)=가면의 닌자 - 하나마루 (일본판)
Kamen Rider Club (Japan)=가면 라이더 클럽
Kamen Rider SD - Granshocker no Yabou (Japan)=가면 라이더 SD - 그랑쇼카의 야망
Kanshakudama Nage Kantarou no Toukaidou Gojuusan Tsugi (Japan)=울화통구슬 던지는 칸타로우의 동해도오십삼차
Karakuri Kengou Den Musashi Lord - Karakuribito Hashiru (Japan)=카라쿠리 검호 전 - 무사시 로드
Karaoke Studio (Japan)=가라오케 스튜디오
Karaoke Studio Senyou Cassette Vol. 1 (Japan)=가라오케 스튜디오 전용 카세트 Vol. 1
Karaoke Studio Senyou Cassette Vol. 2 (Japan)=가라오케 스튜디오 전용 카세트 Vol. 2
Karate Champ (USA) (Rev 1)=가라테 챔프 / 공수도
Karate Champ (USA)=가라테 챔프 / 공수도
Karate Kid, The (USA)=가라테 키드
Karateka (Japan) (Beta)=카라테카 (일본판)(베타)
Karateka (Japan)=카라테카
Karnov (Japan) (Rev 1)=카르노브 (일본판)(개정판 1)
Karnov (Japan)=카르노브 (일본판)
Karnov (USA)=카르노브
Kawa no Nushi Tsuri (Japan)=강의 낚시꾼
Kazama Jun to Asama Yuuko no AV Dragon Mahjong (Japan) (Unl)=카자마 준과 아사마 유코의 AV 드래곤 마작
Keiba Simulation - Honmei (Japan)=경마 시뮬레이션 - 본명
Kekkyoku Nankyoku Daibouken (Japan) (Rev 1)=결국 남극 대탐험
Kekkyoku Nankyoku Daibouken (Japan)=결국 남극 대탐험 (일본판)
Kero Kero Keroppi no Daibouken (Japan)=케로 케로 케로피의 대모험
Kero Kero Keroppi no Daibouken 2 - Donuts Ike wa Oosawagi! (Japan)=케로 케로 케로피의 대모험 2 - 도너츠 연못 물결 대소동!
Keroppi to Keroriinu no Splash Bomb! (Japan)=케로피 와 케로리누의 스플래쉬 봄!
Ki no Bouken - The Quest of Ki (Japan) (Namcot Collection)=카이의 모험 (일본판)
Ki no Bouken - The Quest of Ki (Japan)=카이의 모험
Kick Off (Europe)=킥 오프
Kickle Cubicle (Europe)=킥클 큐비클
Kickle Cubicle (USA)=킥클 큐비클
KickMaster (USA)=킥마스터
Kid Dracula (USA, Europe) (Castlevania Anniversary Collection)=키드 드라큘라 (미국,유럽판)(악마성 기념판 컬렉션)
Kid Icarus (USA, Europe) (Rev 1) (Virtual Console)=키드 이카루스 (미국,유럽판)(개정판 1)(버추얼 콘솔)
Kid Icarus (USA, Europe) (Rev 1)=키드 이카루스
Kid Icarus (USA, Europe)=키드 이카루스 (미국,유럽판)
Kid Klown in Night Mayor World (USA)=키드 크라운 인 나이트 메이어 월드
Kid Kool and the Quest for the Seven Wonder Herbs (USA)=키드 쿨
Kid Niki - Radical Ninja (USA) (Rev 1)=키드 니키 - 라디칼 닌자 / 똘이장군
Kid Niki - Radical Ninja (USA)=키드 니키 - 라디칼 닌자 / 똘이장군
Kiddy Sun in Fantasia (Asia)=키디 선 인 판타지아 (아시아판)
Kidou Senshi Z Gundam - Hot Scramble (Japan) (Final Version)=기동전사 Z 건담 - 핫 스크럼블 (일본판)(최종판)
Kidou Senshi Z Gundam - Hot Scramble (Japan)=기동전사 Z 건담 - 핫 스크럼블
King Kong 2 - Ikari no Megaton Punch (Japan)=킹콩 2 - 분노의 메가톤 펀치
King Neptune's Adventure (USA) (Beta) (Unl)=킹 넵튠스 어드벤처 (베타)(해적판)
King Neptune's Adventure (USA) (Unl)=킹 넵튠스 어드벤처
King of Kings (Japan) (Namcot Collection)=킹 오브 킹스 (일본판)
King of Kings (Japan)=킹 오브 킹스
King of Kings, The - The Early Years (USA) (v1.1) (Unl)=킹 오브 킹스 (v1.1)(해적판)
King of Kings, The - The Early Years (USA) (v1.2) (Unl)=킹 오브 킹스 (v1.2)(해적판)
King of Kings, The - The Early Years (USA) (v1.3) (Unl)=킹 오브 킹스 (v1.3)(해적판)
King of Kings, The - The Early Years (USA) (v5.0) (Unl)=킹 오브 킹스
King's Knight (Japan) (Virtual Console)=킹스 나이트 (일본판)(버추얼 콘솔)
King's Knight (Japan)=킹스 나이트 (일본판)
King's Knight (USA) (Virtual Console)=킹스 나이트 (버추얼 콘솔)
King's Knight (USA)=킹스 나이트
King's Quest V (USA)=킹스 퀘스트 5
Kings of the Beach - Professional Beach Volleyball (USA)=킹스 오브 더 비치 - 프로 비치 발리볼
Kinnikuman - Muscle Tag Match (Japan) (Rev 1)=근육맨 - 머슬 태그 매치 (일본판)(개정판 1)
Kinnikuman - Muscle Tag Match (Japan)=근육맨 - 머슬 태그 매치 (일본판)
Kirby's Adventure (Canada)=커비의 어드벤처 (캐나다판)
Kirby's Adventure (Europe)=커비의 어드벤처
Kirby's Adventure (France)=커비의 어드벤처 (프랑스판)
Kirby's Adventure (Germany)=커비의 어드벤처 (독일판)
Kirby's Adventure (USA) (Rev 1)=커비의 어드벤처 (개정판 1)
Kirby's Adventure (USA)=커비의 어드벤처
Kiteretsu Daihyakka (Japan)=키테레츠 대백과
Kitty's Catch (USA) (Proto) (Unl)=키티스 캐치
Kiwi Kraze - A Bird-Brained Adventure! (USA)=키위 크레이즈
Kkachi-wa Norae Chingu (Korea) (Unl)=까치와 노래친구
KlashBall (USA)=크래쉬 볼
Klax (Japan)=클락스
Klax (USA) (Beta) (Unl)=클락스 (베타)(해적판)
Klax (USA) (Unl)=클락스 (해적판)
Knight Rider (Europe)=전격 Z 작전 - 나이트 라이더
Knight Rider (Japan)=전격 Z 작전 - 나이트 라이더 (일본판)
Knight Rider (USA)=전격 Z 작전 - 나이트 라이더
Koko Adventure (Korea) (Unl)=코코 어드벤처
Konami Hyper Soccer (Europe)=코나미 하이퍼 사커
Konami Wai Wai World (Japan)=코나미 와이 와이 월드
Konamic Sports in Seoul (Japan)=코나믹 스포츠 인 서울 (일본판)
Korean Igo (Korea) (Unl)=장두진의 바둑교실
Kouryuu Densetsu Villgust Gaiden (Japan)=갑룡전설 빌거스트 외전
Koushien (Japan)=갑자원
Krazy Kreatures (USA) (Rev A) (Unl)=크레이지 크리쳐
Krazy Kreatures (USA) (Unl)=크레이지 크리쳐 (해적판)
Krion Conquest, The (USA)=크라이언 컨퀘스트
Krusty's Fun House (Europe)=크러스티의 펀 하우스
Krusty's Fun House (USA)=크러스티의 펀 하우스
Kujaku Ou (Japan)=공작왕
Kujaku Ou II (Japan)=공작왕 2
Kung Fu (Europe)=쿵후
Kung Fu (Japan, USA)=쿵후
Kung-Fu Heroes (USA)=쿵후 히어로즈
Kunio-kun no Nekketsu Soccer League (Japan)=쿠니오군의 열혈 사커 리그
Kurogane Hiroshi no Yosou Daisuki! - Kachiuma Densetsu (Japan)=쿠로가네 히로시의 예상 좋아! - 승마전설
Kyonshiizu 2 (Japan) (Sample)=강시 2 (일본판)(샘플)
Kyonshiizu 2 (Japan)=강시 2
Kyoro-chan Land (Japan)=쿄로짱 랜드 (일본판)
Kyoto Hana no Misshitsu Satsujin Jiken (Japan)=교토 꽃의 밀실 살인사건
Kyoto Ryuu no Tera Satsujin Jiken (Japan)=코토 용의 절 살인사건
Kyouryuu Sentai Zyuranger (Japan)=공룡 전대 쥬렌쟈
Kyuukyoku Harikiri Koushien (Japan)=구극 하리키리 갑자원
Kyuukyoku Harikiri Stadium (Japan)=구극 하리키리 스타디움 (일본판)
Kyuukyoku Harikiri Stadium - '88 Senshu Shin Data Version (Japan)=구극 하리키리 스타디움 - 88 선수 신 데이타 버전
Kyuukyoku Harikiri Stadium - Heisei Gannen Ban (Japan)=구극 하리키리 스타디움 - 평성원년판
Kyuukyoku Harikiri Stadium III (Japan)=구극 하리키리 스타디움 3
Kyuukyoku Tiger (Japan)=구극 타이거 (일본판)
L.A Cop - Miss. Peach World (Japan) (Unl)=LA 캅 - 미스 피치 월드
Labyrinth (Japan)=라비린스
Lagrange Point (Japan)=라그랑쥬 포인트
Lasalle Ishii no Child's Quest (Japan)=라사루 이시의 차일드스 퀘스트
Laser Invasion (USA)=레이져 인베이션
Last Action Hero (USA)=라스트 액션 히어로
Last Armageddon (Japan)=라스트 아마겟돈
Last Ninja, The (USA)=라스트 닌자
Last Starfighter, The (USA)=라스트 스타파이터
Law of the West (Japan)=서부의 법
Layla (Japan)=레이라
Lee Trevino's Fighting Golf (Europe)=리 트레비노의 파이팅 골프
Lee Trevino's Fighting Golf (USA)=리 트레비노의 파이팅 골프
Legacy of the Wizard (USA)=마법사의 유산
Legacy of the Wizard (USA, Europe) (Namco Museum Archives Vol 2)=마법사의 유산 (미국,유럽판)
Legend of Kage, The (USA) (Virtual Console)=레전드 오브 카게 (버추얼 콘솔)
Legend of Kage, The (USA)=레전드 오브 카게
Legend of Prince Valiant, The (Europe)=프린스 벨리언트
Legend of Robin Hood, The (USA) (Proto)=로빈후드의 전설
Legend of Zelda, The (Europe) (Rev 1) (Virtual Console)=젤다의 전설 (유럽판)(개정판 1)(버추얼 콘솔)
Legend of Zelda, The (Europe) (Rev 1)=젤다의 전설
Legend of Zelda, The (Europe)=젤다의 전설 (유럽판)
Legend of Zelda, The (USA) (Collector's Edition)=젤다의 전설
Legend of Zelda, The (USA) (Rev 1) (GameCube Edition)=젤다의 전설 (개정판 1)(게임큐브 버전)
Legend of Zelda, The (USA) (Rev 1) (Virtual Console)=젤다의 전설 (개정판 1)(버추얼 콘솔)
Legend of Zelda, The (USA) (Rev 1)=젤다의 전설 (개정판 1)
Legend of Zelda, The (USA)=젤다의 전설
Legendary Wings (USA)=아레스의 날개 / 레전더리 윙스
Legends of the Diamond - The Baseball Championship Game (USA)=레전즈 오브 더 다이아몬드
Lei Dian II - Thunderbolt Fighting Plane (Asia) (En) (Unl)=뇌전 2
Lemmings (Europe)=레밍즈
Lemmings (USA)=레밍즈
Lethal Weapon (Europe)=리썰 웨폰
Lethal Weapon (USA)=리썰 웨폰
Life Force (USA) (Rev 1)=라이프 포스 (개정판 1)
Life Force (USA)=라이프 포스
Life Force - Salamander (Europe) (Virtual Console)=라이프 포스 - 사라맨더 (유럽판)(버추얼 콘솔)
Life Force - Salamander (Europe)=라이프 포스 - 사라맨더
Lightgun Game 2 in 1 - Cosmocop + Cyber Monster (Asia) (Ja) (Unl)=라이트건 게임 2합팩 - 코스모캅 + 사이버 몬스터
Lightgun Game 2 in 1 - Tough Cop + Super Tough Cop (Asia) (Ja) (Unl)=라이트건 게임 2합팩 - 터프캅 + 슈퍼 터프캅
Lin Ze Xu Jin Yan (Asia) (Unl)=임칙서금연
Linus Spacehead's Cosmic Crusade (USA) (En,Fr,De,Es) (Unl)=리누스 스페이스헤드의 코스믹 크루세이드 (해적판)
Lion King, The (Europe)=라이온 킹
Lipple Island (Japan)=립플 아일랜드
Little League Baseball - Championship Series (USA)=리틀 리그 베이스 볼 - 챔피온쉽 시리즈
Little Magic (Japan)=리틀 매직
Little Mermaid - Ningyo Hime (Japan) (Beta)=인어공주 (일본판)(베타)
Little Mermaid - Ningyo Hime (Japan)=인어공주 (일본판)
Little Mermaid, The (USA)=인어공주
Little Nemo - The Dream Master (Europe)=리틀 네모 - 더 드림 마스터
Little Nemo - The Dream Master (USA)=리틀 네모 - 더 드림 마스터
Little Ninja Brothers (Europe)=리틀 닌자 브라더스
Little Ninja Brothers (USA)=리틀 닌자 브라더스
Little Red Hood (Australia) (Unl)=빨간 망토 소녀
Little Red Hood - Xiao Hong Mao (Asia) (Ja) (Unl)=빨간 망토 소녀 (아시아판)(일본어)(해적판)
Little Samson (Europe)=리틀 삼손
Little Samson (USA)=리틀 삼손
Locksmith (Asia) (Ja) (PAL) (Unl)=록스미스
Lode Runner (Japan) (Virtual Console)=로드 러너 (일본판)(버추얼 콘솔)
Lode Runner (Japan)=로드 러너 (일본판)
Lode Runner (USA)=로드 러너
Lode Runner (USA, Europe) (Virtual Console)=로드 러너 (미국,유럽판)(버추얼 콘솔)
Lone Ranger, The (USA)=론 레인져
Loopz (USA)=룹즈
Lord of King, The (Japan)=로드 오브 킹 (일본판)
Lost Word of Jenny - Ushinawareta Message (Japan)=로스트 워드 오브 제니
Lot Lot (Japan)=랏 랏
Low G Man - The Low Gravity Man (Europe)=로우 G 맨
Low G Man - The Low Gravity Man (USA)=로우 G 맨
Lucky Bingo 777 (Asia) (Ja) (PAL) (Unl)=럭키 빙고 777
Lunar Ball (Japan)=루나 볼 (일본판)
Lunar Pool (Europe)=루나 풀
Lunar Pool (USA)=루나 풀
Lupin Sansei - Pandora no Isan (Japan)=루팡 3세 - 판도라의 유산
M.C. Kids (USA) (Beta)=M.C. 키드 (베타)
M.C. Kids (USA)=M.C. 키드
M.U.L.E. (USA)=M.U.L.E.
M.U.S.C.L.E. - Tag Team Match (USA)=머슬 - 태그 팀 매치
M82 Game Selectable Working Product Display (Europe) (Demo) (Kiosk)=M82 게임 선택 디스플레이
Mach Rider (Europe) (Virtual Console)=맥 라이더 (유럽판)(버추얼 콘솔)
Mach Rider (Europe)=맥 라이더
Mach Rider (Japan, USA) (Rev 1) (Virtual Console)=맥 라이더 (개정판 1)(버추얼 콘솔)
Mach Rider (Japan, USA) (Rev 1)=맥 라이더 (개정판 1)
Mach Rider (Japan, USA) (Virtual Console)=맥 라이더 (버추얼 콘솔)
Mach Rider (Japan, USA)=맥 라이더
Mad City (Japan) (Beta)=매드 시티 (일본판)(베타)
Mad City (Japan) (Virtual Console)=매드 시티 (일본판)(버추얼 콘솔)
Mad City (Japan)=매드 시티 (일본판)
Mad Max (USA)=매드 맥스
Madoola no Tsubasa (Japan) (Sample)=마두라의 날개 (일본판)(샘플)
Madoola no Tsubasa (Japan)=마두라의 날개
Mafat Conspiracy, The (USA)=마팻 컨스피러시 - 고르고 13
Magic Block (Asia) (En) (Mega Soft) (Unl)=매직 블럭
Magic Bubble (Asia) (En) (Unl)=매직 버블 (아시아판)(영어)(해적판)
Magic Candle, The (Japan)=마법 양초
Magic Carpet 1001 (USA) (Unl)=매직 카펫 1001 (해적판)
Magic Cube (Asia) (Ja) (PAL) (Unl)=매직 큐브
Magic Darts (Japan)=매직 다츠 (일본판)
Magic Darts (USA)=매직 다츠
Magic Giral (Asia) (Unl)=매직 기랄
Magic Jewelry (Asia) (Ja) (Unl)=매직 쥬얼리
Magic Jewelry 2 (Asia) (Ja) (Unl)=매직 쥬얼리 2
Magic John (Japan)=매직 존 (일본판)
Magic Johnson's Fast Break (USA)=매직 존슨의 패스트 브레이크
Magic Kid Googoo (Korea) (Unl)=요술동자 구구
Magic of Scheherazade, The (USA)=매직 오브 세라쟈드
Magical Kid's Doropie (Japan) (Beta)=매지컬 키드 도피 (일본판)(베타)
Magical Kid's Doropie (Japan)=매지컬 키드 도피 (일본판)
Magical Mathematics (Asia) (Ja) (NTSC) (Unl)=매지컬 매스매틱스
Magical Mathematics (Asia) (Ja) (PAL) (Unl)=매지컬 매스매틱스 (아시아판)(일본어)(PAL)(해적판)
Magical Taruruuto-kun - Fantastic World!! (Japan) (Rev 1)=매지컬 타루루토군 - 판타스틱 월드!!
Magical Taruruuto-kun - Fantastic World!! (Japan)=매지컬 타루루토군 - 판타스틱 월드!! (일본판)
Magical Taruruuto-kun 2 - Mahou Daibouken (Japan)=매지컬 타루루토군 2 - 마법 대 모험
Magician (USA) (Beta 1) (1990-03-02)=매지션 (배타 1)
Magician (USA) (Beta 2)=매지션 (베타 2)
Magician (USA) (Beta 3)=매지션 (베타 3)
Magician (USA)=매지션
Magmax (Japan)=매그 맥스 (일본판)
Magmax (USA)=매그 맥스
Magnum Kikiippatsu - Empire City - 1931 (Japan)=매그넘 위기 일발 - 제국 도시 - 1931
Maharaja (Japan)=마하라자
Mahjang Companion (Asia) (Ja) (Hacker) (Unl)=마작 컴패니언 (아시아판)(일본어)(해커)(해적판)
Mahjang Companion (Asia) (Ja) (Sachen) (Unl)=마작 컴패니언
Mahjong (Japan) (Rev 1)=마작 (일본판)(개정판 1)
Mahjong (Japan) (Rev 2) (GameCube Edition)=마작 (일본판)(개정판 2)(게임큐브 버전)
Mahjong (Japan) (Rev 2)=마작
Mahjong (Japan)=마작 (일본판)
Mahjong Academy (Asia) (Ja) (Unl)=마작 아카데미
Mahjong Block (Asia) (Idea-Tek) (Unl)=마작 블록 (아시아판)(해적판)
Mahjong Block (Asia) (TXC) (Unl)=마작 블록 (아시아판)(해적판)
Mahjong Club Nagatachou - Sousaisen (Japan)=마작 클럽 - 영전정
Mahjong RPG Dora Dora Dora (Japan)=마작 RPG 도라 도라 도라
Mahjong Samit - Kabukicho Hen (Japan) (Unl)=마작 서미트 - 카부키조 편
Mahjong Taikai (Japan)=마작 대회
Mahjong Taisen (Japan)=마작 대전
Mahjong Trap - Si Cuan Ma Que (Asia) (Ja) (Unl)=사천마작 (아시아판)(일본어)(해적판)
Mahjong World, The - Ma Que Shi Jie (Asia) (Ja) (NTSC) (Unl)=마작 월드
Mahjong World, The - Ma Que Shi Jie (Asia) (Ja) (PAL) (Unl)=마작 월드 (아시아판)(일본어)(PAL)(해적판)
Mahou no Princess Minky Momo - Remember Dream (Japan)=마법의 공주 밍키 모모 - 리멤버 드림
Maison Ikkoku (Japan)=메종일각 - 도레미하우스
Majaventure - Mahjong Senki (Japan)=마자벤쳐 - 마작 전기
Major League (Japan)=메이저 리그
Major League Baseball (USA) (Rev 1)=메이저 리그 베이스볼
Major League Baseball (USA)=메이저 리그 베이스볼
Majou Densetsu II - Daimashikyou Galious (Japan)=마성전설2 - 대마주교 가리우스
Makai Island (USA) (Proto)=마계 아일랜드 (시험판)
Makaimura (Japan)=마계촌 (일본판)
Maniac Mansion (Europe)=메니악 맨션
Maniac Mansion (France)=메니악 맨션 (프랑스판)
Maniac Mansion (Germany)=메니악 맨션 (독일판)
Maniac Mansion (Italy)=메니악 맨션 (이탈리아판)
Maniac Mansion (Japan)=메니악 맨션
Maniac Mansion (Spain)=메니악 맨션 (스페인판)
Maniac Mansion (Sweden)=메니악 맨션 (스웨덴판)
Maniac Mansion (USA) (Beta)=메니악 맨션 (베타)
Maniac Mansion (USA)=메니악 맨션
Mappy (Japan)=마피
Mappy (World) (Namcot Collection, Namco Museum Archives Vol 1)=마피 (세계판)
Mappy Kids (Japan)=마피 키즈
Mappy-Land (Japan)=마피 랜드 (일본판)
Mappy-Land (USA)=마피 랜드
Mappy-Land (USA, Europe) (Namco Museum Archives Vol 2)=마피 랜드 (미국,유럽판)
Mappy-Land (USA, Europe) (Virtual Console)=마피 랜드 (미국,유럽판)(버추얼 콘솔)
Marble Madness (Europe)=마블 매드니스
Marble Madness (USA)=마블 매드니스
Mario & Yoshi (Europe)=마리오 & 요시
Mario Bros. (Europe) (PAL-MA-0)=마리오 브라더스 (유럽판)
Mario Bros. (Europe) (PAL-MC-0, Classic Series)=마리오 브라더스
Mario Bros. (World) (GameCube Edition)=마리오 브라더스 (세계판)(게임큐브 버전)
Mario Bros. (World)=마리오 브라더스 (세계판)
Mario is Missing! (Europe)=마리오가 사라졌다!
Mario is Missing! (USA)=마리오가 사라졌다!
Mario Open Golf (Japan) (Rev 1) (Virtual Console)=마리오 오픈 골프 (일본판)(개정판 1)(버추얼 콘솔)
Mario Open Golf (Japan) (Rev 1)=마리오 오픈 골프 (일본판)(개정판 1)
Mario Open Golf (Japan)=마리오 오픈 골프 (일본판)
Mario's Time Machine (USA)=마리오의 타임 머신
Marusa no Onna (Japan)=마루사의 여인
Mashin Eiyuuden Wataru Gaiden (Japan)=마신 영웅전 와타루 외전
Mashou (Japan)=마성 (일본판)
Master Chu and the Drunkard Hu (Asia) (Ja) (PAL) (Unl)=마스터 츄 & 주정뱅이 휴 (아시아판)(일본어)(PAL)(해적판)
Master Chu and the Drunkard Hu (USA) (Unl)=마스터 츄 & 주정뱅이 휴
Master Shooter (Asia) (Ja) (Unl)=마스터 슈터
Masuzoe Youichi - Asa Made Famicom (Japan)=마스조에 요우이치 - 아침까지 패미컴
Matendouji (Japan)=마천동자 (일본판)
Matsumoto Tooru no Kabushiki Hisshou Gaku (Japan)=마츠모토 토오루의 주식 필승학
Matsumoto Tooru no Kabushiki Hisshou Gaku - Part II (Japan)=마츠모토 토오루의 주식 필승학 - Part 2
Max Warrior - Wakusei Kaigenrei (Japan)=맥스 워리어 - 혹성계엄령 (일본판)
Maxi 15 (USA) (Rev 1) (Unl)=맥시 15
Maxi 15 (USA) (Unl)=맥시 15 (해적판)
Maxi-15 Pack (Australia) (Unl)=맥시 15 팩 (호주판)(해적판)
McDonaldland (Europe)=맥도날드랜드
McDonaldland (France)=맥도날드랜드 (프랑스판)
Mechanized Attack (USA)=메커나이즈드 어택
Mega Man (Europe)=메가맨 / 록맨
Mega Man (USA) (Virtual Console)=메가맨 / 록맨 (버추얼 콘솔)
Mega Man (USA)=메가맨 / 록맨
Mega Man (World) (Mega Man Legacy Collection)=메가맨 / 록맨 (세계판)
Mega Man 2 (Europe) (Virtual Console)=메가맨 2 / 록맨 2 (유럽판)(버추얼 콘솔)
Mega Man 2 (Europe)=메가맨 2 / 록맨 2
Mega Man 2 (USA) (Virtual Console)=메가맨 2 / 록맨 2 (버추얼 콘솔)
Mega Man 2 (USA)=메가맨 2 / 록맨 2
Mega Man 2 (World) (Mega Man Legacy Collection)=메가맨 2 / 록맨 2 (세계판)
Mega Man 3 (Europe) (Rev 1) (Virtual Console)=메가맨 3 / 록맨 3 (유럽판)(개정판 1)(버추얼 콘솔)
Mega Man 3 (Europe) (Rev 1)=메가맨 3 / 록맨 3
Mega Man 3 (Europe)=메가맨 3 / 록맨 3 (유럽판)
Mega Man 3 (USA) (Beta)=메가맨 3 / 록맨 3 (베타)
Mega Man 3 (USA) (Virtual Console)=메가맨 3 / 록맨 3 (버추얼 콘솔)
Mega Man 3 (USA)=메가맨 3 / 록맨 3
Mega Man 3 (World) (Mega Man Legacy Collection)=메가맨 3 / 록맨 3 (세계판)
Mega Man 4 (Europe) (Virtual Console)=메가맨 4 / 록맨 4 (유럽판)(버추얼 콘솔)
Mega Man 4 (Europe)=메가맨 4 / 록맨 4
Mega Man 4 (USA) (Rev 1)=메가맨 4 / 록맨 4 (개정판 1)
Mega Man 4 (USA) (Virtual Console)=메가맨 4 / 록맨 4 (버추얼 콘솔)
Mega Man 4 (USA)=메가맨 4 / 록맨 4
Mega Man 4 (World) (Mega Man Legacy Collection)=메가맨 4 / 록맨 4 (세계판)
Mega Man 5 (Europe) (Virtual Console)=메가맨 5 / 록맨 5 (유럽판)(버추얼 콘솔)
Mega Man 5 (Europe)=메가맨 5 / 록맨 5
Mega Man 5 (USA) (Virtual Console)=메가맨 5 / 록맨 5 (버추얼 콘솔)
Mega Man 5 (USA)=메가맨 5 / 록맨 5
Mega Man 5 (World) (Mega Man Legacy Collection)=메가맨 5 / 록맨 5 (세계판)
Mega Man 6 (USA)=메가맨 6 / 록맨 6
Mega Man 6 (World) (Mega Man Legacy Collection)=메가맨 6 / 록맨 6 (세계판)
Mei Guo Fu Hao - American Man (Asia) (Unl)=미국부자
Meiji Ishin (Japan)=메이지 유신
Meikyuu Kumikyoku - Milon no Daibouken (Japan) (Sample)=미궁조곡 - 미론의 비밀의 성 (일본판)(샘플)
Meikyuu Kumikyoku - Milon no Daibouken (Japan) (Virtual Console)=미궁조곡 - 미론의 비밀의 성 (일본판)(버추얼 콘솔)
Meikyuu Kumikyoku - Milon no Daibouken (Japan)=미궁조곡 - 미론의 비밀의 성 (일본판)
Meikyuu no Tatsujin - Daimeiro (Japan)=미궁의 달인 - 대미로
Meikyuu-jima (Japan)=미궁도 (일본판)
Meimon! Daisan Yakyuubu (Japan)=명문! 제 3 야구 부
Meimon! Takonishi Ouendan - Kouha 6 Nin Shuu (Japan)=명문! 다코니시 응원단 - 경파 6인 중
Meitantei Holmes - Kiri no London Satsujin Jiken (Japan)=명탐정 홈즈 - 안개의 런던 살인사건
Meitantei Holmes - M kara no Chousenjou (Japan)=명탐정 홈즈 - M으로부터의 도전장
Menace Beach (USA) (Unl)=협박 해변
Mendel Palace (USA)=멘델 팰리스
Mendel Palace (USA, Europe) (Namco Museum Archives Vol 2)=멘델 팰리스 (미국,유럽판)
Meng Huan - Xiang Shuai Chuan Qi Zhi Xue Hai Piao Ling (Asia) (Unl)=몽환
Mermaids of Atlantis - The Riddle of the Magic Bubble (USA) (Unl)=아틀란티스의 인어 - 마법 거품의 수수께끼
Metal Fighter (Asia) (Ja) (Sachen) (Unl)=메탈 파이터 (아시아판)(일본어)(사첸)(해적판)
Metal Fighter (USA) (Unl)=메탈 파이터
Metal Fighter Mu (Japan) (Unl)=메탈 파이터 뮤 (일본판)(해적판)
Metal Flame - Psy Buster (Japan)=강철 불꽃 사이 부스터 (일본판)
Metal Force (Korea) (Unl)=메탈 포스
Metal Gear (Europe)=메탈 기어
Metal Gear (Japan)=메탈 기어 (일본판)
Metal Gear (USA)=메탈 기어
Metal Max (Japan) (Virtual Console)=메탈 맥스 (일본판)(버추얼 콘솔)
Metal Max (Japan)=메탈 맥스
Metal Slader Glory (Japan) (Virtual Console)=메탈 슬레이더 글로리 (일본판)(버추얼 콘솔)
Metal Slader Glory (Japan)=메탈 슬레이더 글로리
Metal Storm (USA)=메탈 스톰
MetalMech - Man & Machine (USA)=메탈메크 - 맨 & 머신
Metro-Cross (Japan) (Namcot Collection)=메트로 크로스 (일본판)
Metro-Cross (Japan)=메트로 크로스
Metroid (Europe) (Virtual Console)=메트로이드 (유럽판)(버추얼 콘솔)
Metroid (Europe)=메트로이드
Metroid (USA) (Virtual Console)=메트로이드 (버추얼 콘솔)
Metroid (USA)=메트로이드
Mezase Pachi Pro - Pachio-kun (Japan) (Beta)=노려라 파치 프로 - 파치오 군 (일본판)(베타)
Mezase Pachi Pro - Pachio-kun (Japan)=노려라 파치 프로 - 파치오 군
Mezase! Top Pro - Green ni Kakeru Yume (Japan)=노려라! 탑 프로 - 그린에 거는 꿈
Michael Andretti's World GP (USA)=마이클 안드레티 의 월드 GP
Mick & Mack as the Global Gladiators (USA) (Proto) (1993-05-28) (Alt)=믹 앤 맥 글로벌 글라디에이터 (시험판)(대체)
Mick & Mack as the Global Gladiators (USA) (Proto) (1993-05-28)=믹 앤 맥 글로벌 글라디에이터 (시험판)
Mick & Mack as the Global Gladiators (USA) (Proto) (1993-06-16)=믹 앤 맥 글로벌 글라디에이터 (시험판)
Mick & Mack as the Global Gladiators (USA) (Proto) (1993-06-30)=믹 앤 맥 글로벌 글라디에이터 (시험판)(1993-06-30)
Mick & Mack as the Global Gladiators (USA) (Proto) (1993-07-09)=믹 앤 맥 글로벌 글라디에이터
Mickey Mouse - Dream Balloon (USA) (Beta)=미키 마우스 - 꿈의 풍선 (베타)
Mickey Mouse - Fushigi no Kuni no Daibouken (Japan)=미키 마우스 - 이상한 나라의 대모험 (일본판)
Mickey Mouse III - Yume Fuusen (Japan)=미키 마우스 3 - 꿈의 풍선 (일본판)
Mickey Mousecapade (USA)=미키 마우스카페이드
Mickey's Adventure in Numberland (USA)=미키 의 숫자나라 속 모험
Mickey's Safari in Letterland (USA)=미키 의 편지나라 속 사파리
Micro Machines (Europe) (Unl)=마이크로 머신
Micro Machines (USA) (Aladdin Compact Cartridge) (Unl)=마이크로 머신 (알라딘 컴팩트 카트리지)(해적판)
Micro Machines (USA) (Unl)=마이크로 머신 (해적판)
MiG 29 - Soviet Fighter (USA) (Unl)=미그 - 29 소비엣 파이터
Might & Magic - Secret of the Inner Sanctum (USA)=마이트 앤드 매직
Might and Magic - Book One - Secret of the Inner Sanctum (Japan)=마이트 앤드 매직 - 1장 - 지성소의 비밀 (일본판)
Mighty Bomb Jack (Europe)=마이티 봄 잭
Mighty Bomb Jack (Japan) (Rev 1) (Virtual Console)=마이티 봄 잭 (일본판)(개정판 1)(버추얼 콘솔)
Mighty Bomb Jack (Japan) (Rev 1)=마이티 봄 잭 (일본판)(개정판 1)
Mighty Bomb Jack (Japan)=마이티 봄 잭 (일본판)
Mighty Bomb Jack (USA)=마이티 봄 잭
Mighty Final Fight (Europe)=마이티 파이널 파이트
Mighty Final Fight (Japan)=마이티 파이널 파이트 (일본판)
Mighty Final Fight (USA)=마이티 파이널 파이트
Mike Tyson's Intergalactic Power Punch (USA) (Beta) [b]=마이크 타이슨의 인터갤럭틱 파워 펀치 (베타)
Mike Tyson's Punch-Out!! (Europe) (Rev 1)=마이크 타이슨의 펀치아웃!! (유럽판)(개정판 1)
Mike Tyson's Punch-Out!! (Europe)=마이크 타이슨의 펀치아웃!! (유럽판)
Mike Tyson's Punch-Out!! (Japan, USA) (Rev 1)=마이크 타이슨의 펀치아웃!! (개정판 1)
Mike Tyson's Punch-Out!! (Japan, USA)=마이크 타이슨의 펀치아웃!!
Millionaire (Asia) (Ja) (PAL) (Unl)=백만장자
Millipede (USA)=밀리피드
Millipede - Kyodai Konchuu no Gyakushuu (Japan)=밀리피드 - 거대 곤충의 역습 (일본판)
Milon's Secret Castle (USA) (Virtual Console)=미론의 비밀 성 (버추얼 콘솔)
Milon's Secret Castle (USA)=미론의 비밀 성
Mindblower Pak (Australia) (Unl)=마인드 블로워 팩
Mindseeker (Japan)=마인드시커
Minelvaton Saga - Ragon no Fukkatsu (Japan)=미네르바톤 사가
Mini-Putt (Japan)=미니풋
Minna no Taabou no Nakayoshi Daisakusen (Japan) (Rev 1)=민나와 타부의 나카요시 대작전
Minna no Taabou no Nakayoshi Daisakusen (Japan)=민나와 타부의 나카요시 대작전 (일본판)
Miracle Piano Teaching System, The (France)=기적의 피아노 교육 시스템 (프랑스판)
Miracle Piano Teaching System, The (Germany)=기적의 피아노 교육 시스템 (독일판)
Miracle Piano Teaching System, The (USA)=기적의 피아노 교육 시스템
Miracle Ropit's - 2100 Nen no Daibouken (Japan)=미라클 로핏의 2100 모험
Mirai Shinwa Jarvas (Japan)=미래신화 자바스
Mission - Impossible (Europe)=미션 임파서블
Mission - Impossible (France)=미션 임파서블 (프랑스판)
Mission - Impossible (USA)=미션 임파서블
Mission Cobra (USA) (Unl)=미션 코브라
Mississippi Satsujin Jiken (Japan) (Rev A)=미시시피 살인 사건
Mississippi Satsujin Jiken (Japan)=미시시피 살인 사건 (일본판)
Mito Koumon - Sekai Manyuu Ki (Japan)=수호 황문2 - 세계 만유기
Mitsume ga Tooru (Japan)=삼목동자
Mizushima Shinji no Daikoushien (Japan)=미즈시마 신지의 대 갑자원
Moai-kun (Japan)=모아이 군
Moe Pro! '90 - Kandou Hen (Japan)=모에 프로! 90 - 감동 편 (일본판)
Moe Pro! - Saikyou Hen (Japan)=모에 프로! - 최강 편 (일본판)
Moero TwinBee - Cinnamon Hakase o Sukue! (Japan) (Virtual Console)=불타라 트윈비 - 시나몬 박사를 구하라! (일본판)(버추얼 콘솔)
Moero TwinBee - Cinnamon Hakase o Sukue! (Japan)=불타라 트윈비 - 시나몬 박사를 구하라! (일본판)
Moero!! Junior Basket - Two on Two (Japan)=불타라!! 주니어 바스켓 - 2 대 2 (일본판)
Moero!! Juudou Warriors (Japan)=불타라!! 유도 전사들
Moero!! Pro Soccer (Japan)=불타라!! 프로 사커 (일본판)
Moero!! Pro Tennis (Japan)=불타라!! 프로 테니스 (일본판)
Moero!! Pro Yakyuu '88 - Ketteiban (Japan)=불타라!! 프로 야구 88 - 결정 판 (일본판)
Moero!! Pro Yakyuu (Japan) (Beta)=불타라!! 프로 야구 (일본판)(베타)
Moero!! Pro Yakyuu (Japan) (Rev 1)=불타라!! 프로 야구 (일본판)(개정판 1)
Moero!! Pro Yakyuu (Japan) (Rev 2)=불타라!! 프로 야구 (일본판)(개정판 2)
Moero!! Pro Yakyuu (Japan) (Rev 3) (Virtual Console)=불타라!! 프로 야구 (일본판)(개정판 3)(버추얼 콘솔)
Moero!! Pro Yakyuu (Japan) (Rev 3)=불타라!! 프로 야구 (일본판)(개정판 3)
Moero!! Pro Yakyuu (Japan)=불타라!! 프로 야구 (일본판)
Moeru! Oniisan (Japan)=모에루 오니상 (일본판)
Momotarou Densetsu (Japan)=도태랑 전설
Momotarou Densetsu Gaiden (Japan)=도태랑 전설 외전
Momotarou Dentetsu (Japan)=도태랑 전철
Money Game II, The - Kabutochou no Kiseki (Japan)=머니 게임2 - 두정의 기적 (일본판)
Money Game, The (Japan)=머니 게임
Monopoly (France)=모노폴리 (프랑스판)
Monopoly (Germany)=모노폴리 (독일판)
Monopoly (Japan)=모노폴리 (일본판)
Monopoly (USA)=모노폴리
Monster in My Pocket (Europe)=내 주머니 속 괴물
Monster in My Pocket (USA) (Beta) (1991-04-22)=내 주머니 속 괴물 (베타)
Monster in My Pocket (USA)=내 주머니 속 괴물
Monster Maker - 7 Tsu no Hihou (Japan)=몬스터 메이커 - 7인의 비보
Monster Party (USA)=몬스터 파티
Monster Truck Rally (USA)=몬스터 트럭 랠리
Monstruo de los Globos, El (Spain) (Gluk Video) (Unl)=풍선괴물 (스페인판)(글럭 비디오)(해적판)
Monstruo de los Globos, El (Spain) (Rev 1) (Gluk Video) (Unl)=풍선괴물
Moon Crystal (Japan)=문 크리스탈
Moon Ranger (USA) (Unl)=문 레인져
Morita Shougi (Japan)=모리타 장기
Mother (Japan) (Virtual Console)=마더 (일본판)(버추얼 콘솔)
Mother (Japan)=마더
Motocross Champion (Japan)=모토크로스 챔피온
Motor City Patrol (USA)=모터 시티 패트롤
Mottomo Abunai Deka (Japan)=무엇보다 위험한 형사
Moulin Rouge Senki - Melville no Honoo (Japan)=물랑루즈 전기 - 멜빌의 불길
Mouryou Senki Madara (Japan)=망량 전기 마다라
Mr. Gimmick (Europe)=미스터 기믹
Mr. Gimmick (USA) (Proto)=미스터 기믹 (시험판)
Ms. Pac-Man (USA) (Namco)=미즈 팩맨
Ms. Pac-Man (USA) (Tengen) (Unl)=미즈 팩맨
Mugen Senshi Valis (Japan)=몽환 전사 바리스
Muppet Adventure - Chaos at the Carnival (USA)=머펫 어드벤처 - 카오스 엣 더 카니발
Murder Club - Honkaku Mystery Adventure (Japan)=머더러 클럽 - 본격 미스터리 어드벤처
Musashi no Bouken (Japan)=무사시 의 모험
Musashi no Ken - Tadaima Shugyou Chuu (Japan)=무사시의 검 - 지금 수행 중
Mutant Virus, The - Crisis in a Computer World (USA)=뮤턴트 바이러스
My Life My Love - Boku no Yume - Watashi no Negai (Japan)=마이 라이프 마이 러브 - 나의 꿈 - 나의 소원
Mystery Quest (USA)=미스테리 퀘스트
Mystery World Dizzy (Europe) (En,Pt,Pl) (Unl)=미스터리 월드의 디지
Nagagutsu o Haita Neko - Sekai Isshuu 80 Nichi Daibouken (Japan) (Beta)=장화신은 고양이 - 세계일주 80일의 대모험 (일본판)(베타)
Nagagutsu o Haita Neko - Sekai Isshuu 80 Nichi Daibouken (Japan)=장화신은 고양이 - 세계일주 80일의 대모험
Nakajima Satoru - F-1 Hero (Japan)=나카지마 사토루 감수 - F1 히어로 (일본판)
Nakajima Satoru Kanshuu - F-1 Hero 2 (Japan)=나카지마 사토루 감수 - F1 히어로 2
Nakayoshi to Issho (Japan)=나카요시와 함께
Namco Classic (Japan)=남코 클래식
Namco Classic II (Japan) (Namcot Collection)=남코 클래식 2 (일본판)
Namco Classic II (Japan)=남코 클래식 2
Namco Prism Zone - Dream Master (Japan)=남코 프리즘 존 - 드림 마스터
Namcot Mahjong III - Mahjong Tengoku (Japan)=남코 마작 3 - 마작 천국
Nangoku Shirei!! - Spy vs Spy (Japan)=남국지령!! - 스파이 대 스파이
Nantettatte!! Baseball (Japan) (Sample) (1989-12-22)=뭐니뭐니해도!! 야구 (일본판)(샘플)
Nantettatte!! Baseball (Japan)=뭐니뭐니해도!! 야구
Nantettatte!! Baseball + Nantettatte!! Baseball - Ko-Game Cassette - '91 Kaimaku Hen (Japan)=뭐니뭐니해도!! 야구 + 합팩
Nantettatte!! Baseball + Nantettatte!! Baseball - Ko-Game Cassette - OB All Star Hen (Japan)=뭐니뭐니해도!! 야구 + 합팩
Napoleon Senki (Japan)=나폴레옹 전기
NARC (USA)=나크
Navy Blue (Japan)=네이비 블루
Nekketsu Kakutou Densetsu (Japan)=열혈격투 전설
Nekketsu Kouha Kunio-kun (Japan) (Virtual Console)=열혈경파 쿠니오군 (일본판)(버추얼 콘솔)
Nekketsu Kouha Kunio-kun (Japan)=열혈경파 쿠니오군 (일본판)
Nekketsu Koukou Dodgeball-bu (Japan) (Virtual Console)=열혈고교 피구부 (일본판)(버추얼 콘솔)
Nekketsu Koukou Dodgeball-bu (Japan)=열혈고교 피구부 (일본판)
Nekketsu Koukou Dodgeball-bu - Soccer Hen (Japan) (Virtual Console)=열혈고교 피부구 - 축구편 (일본판)(버추얼 콘솔)
Nekketsu Koukou Dodgeball-bu - Soccer Hen (Japan)=열혈고교 피부구 - 축구편 (일본판)
Nekketsu! Street Basket - Ganbare Dunk Heroes (Japan)=열혈! 스트리트 바스켓 - 힘내라 덩크 영웅들
NES Open Tournament Golf (Europe) (Virtual Console)=마리오 오픈 골프 (유럽판)(버추얼 콘솔)
NES Open Tournament Golf (Europe)=마리오 오픈 골프
NES Open Tournament Golf (USA) (Virtual Console)=마리오 오픈 골프 (버추얼 콘솔)
NES Open Tournament Golf (USA)=마리오 오픈 골프
NES Play Action Football (USA) (Virtual Console)=NES 플레이 액션 풋봇 (버추얼 콘솔)
NES Play Action Football (USA)=NES 플레이 액션 풋봇
New Ghostbusters II (Europe)=뉴 고스트 버스터즈 2
New Ghostbusters II (Japan)=뉴 고스트 버스터즈 2 (일본판)
New Ghostbusters II (USA) (Proto)=뉴 고스트 버스터즈 2 (시험판)
New York Nyankies (Japan)=뉴욕 양키즈 (일본판)
NewZealand Story, The (Europe)=뉴질랜드 스토리
NFL (USA)=NFL 풋봇
NHK Gakuen - Space School - Sansu 5 Nen (Jou) (Japan)=NHK 학원 스페이스 스쿨 산수 5학년
NHK Gakuen - Space School - Sansu 6 Nen (Ge) (Japan)=NHK 학원 스페이스 스쿨 산수 6학년
NHK Gakuen - Space School - Sansu 6 Nen (Jou) (Japan)=NHK 학원 스페이스 스쿨 산수 6학년
Nichibutsu Mahjong III - Mahjong G Men (Japan)=니치부츠 마작 3 - 마작 G 맨
Nigel Mansell's World Championship (Europe) (En,Fr,De,Es,It)=나이젤 만셀의 세계 챔피언십
Nigel Mansell's World Championship Racing (USA)=나이젤 만셀의 세계 챔피언십 레이싱
Nightmare on Elm Street, A (USA)=엘름 거리의 악몽
Nightshade (USA)=나이트쉐이드
Nihonichi no Mei Kantoku (Japan)=일본최고의 명감독
Niji no Silk Road (Japan)=무지개의 실크 로드
Ninja Cop Saizou (Japan)=닌자 캅 사이조 (일본판)
Ninja Crusaders (USA)=닌자 크루세이더스
Ninja Crusaders - Ryuuga (Japan)=닌자 크루세이더스 - 용아 (일본판)
Ninja Gaiden (Japan) (Wii U Virtual Console)=닌자 가이덴 (일본판)(Wii U 버추얼 콘솔)
Ninja Gaiden (USA) (Beta)=닌자 가이덴 (베타)
Ninja Gaiden (USA)=닌자 가이덴
Ninja Gaiden - Episode II - The Dark Sword of Chaos (USA) (Sample) (1990-01-18)=닌자 가이덴 2 - 혼돈의 암흑검 (샘플)(1990-01-18)
Ninja Gaiden II - The Dark Sword of Chaos (USA) (Virtual Console)=닌자 가이덴 2 - 혼돈의 암흑검 (버추얼 콘솔)
Ninja Gaiden II - The Dark Sword of Chaos (USA)=닌자 가이덴 2 - 혼돈의 암흑검
Ninja Gaiden III - The Ancient Ship of Doom (USA) (Wii U Virtual Console)=닌자 가이덴 3 - 최후의 고대 선박 (Wii U 버추얼 콘솔)
Ninja Gaiden III - The Ancient Ship of Doom (USA) (Wii Virtual Console)=닌자 가이덴 3 - 최후의 고대 선박 (Wii 버추얼 콘솔)
Ninja Gaiden III - The Ancient Ship of Doom (USA)=닌자 가이덴 3 - 최후의 고대 선박
Ninja Hattori-kun - Ninja wa Syugyou de Gozaru no Maki (Japan) (Beta)=닌자 핫토리 군 (일본판)(베타)
Ninja Hattori-kun - Ninja wa Syugyou de Gozaru no Maki (Japan)=닌자 핫토리 군
Ninja Jajamaru - Ginga Daisakusen (Japan) (Beta)=닌자 자자마루 - 은하 대 작전 (일본판)(베타)
Ninja Jajamaru - Ginga Daisakusen (Japan)=닌자 자자마루 - 은하 대 작전
Ninja Jajamaru-kun (Japan)=닌자 자자마루 군
Ninja Jajamaru-kun (World) (Ja) (Virtual Console)=닌자 자자마루 군 (세계판)(일본어)(버추얼 콘솔)
Ninja Kid (USA)=닌자 키드
Ninja Ryuuken Den (Japan) (Wii Virtual Console)=닌자용검전 (일본판)(Wii 버추얼 콘솔)
Ninja Ryuuken Den (Japan)=닌자용검전 (일본판)
Ninja Ryuuken Den II - Ankoku no Jashin Ken (Japan)=닌자용검전 2 - 혼돈의 암흑검 (일본판)
Ninja Ryuuken Den III - Yomi no Hakobune (Japan)=닌자용검전 3 - 황천의 방주 (일본판)
Ninja-kun - Ashura no Shou (Japan)=닌자군 - 아수라의 장
Ninja-kun - Majou no Bouken (Japan) (Rev 1)=닌자군 - 마성의 모험
Ninja-kun - Majou no Bouken (Japan)=닌자군 - 마성의 모험 (일본판)
Ninjara Hoi! (Japan)=닌자라 호이!
Nintendo - NTF2 System Cartridge (USA)=닌텐도 - NTF2 시스템 카트리지
Nintendo - NTF2 Test Cartridge (NES Test) (USA) (Rev 1) (Test Program)=닌텐도 - NTF2 테스트 카트리지
Nintendo - NTF2 Test Cartridge (USA) (Test Program)=닌텐도 - NTF2 테스트 카트리지
Nintendo World Championships 1990 (USA) (Competition Cart)=닌텐도 월드 챔피언십 1990
Nintendo World Class Service - Control Deck Test Cartridge (USA) (Test Program)=닌텐도 월드 클래스 서비스 - 컨트롤덱 테스트 카트리지
Nintendo World Class Service - Joystick Test Cartridge (USA) (Test Program)=닌텐도 월드 클래스 서비스 - 조이스틱 테스트 카트리지
Nintendo World Class Service - Port Test Cartridge (USA) (Test Program)=닌텐도 월드 클래스 서비스 - 포트 테스트 카트리지
Nintendo World Class Service - Power Pad Test Cartridge (USA) (Test Program)=닌텐도 월드 클래스 서비스 - 파워패드 테스트 카트리지
Nintendo World Cup (Europe) (Rev 1)=닌텐도 월드컵 (유럽판)(개정판 1)
Nintendo World Cup (Europe) (Rev 2)=닌텐도 월드컵
Nintendo World Cup (Europe)=닌텐도 월드컵 (유럽판)
Nintendo World Cup (USA)=닌텐도 월드컵
Nishimura Kyoutarou Mystery - Blue Train Satsujin Jiken (Japan)=니시무라 쿄타로 미스터리 - 블루 트레인 살인 사건
Nishimura Kyoutarou Mystery - Super Express Satsujin Jiken (Japan)=니시무라 쿄타로 미스터리 - 슈퍼 익스프레스 살인 사건
Noah's Ark (Europe)=노아의 방주
Nobunaga no Yabou - Bushou Fuuun Roku (Japan) (Rev A)=노부나가의 야망 - 무장 풍운록
Nobunaga no Yabou - Bushou Fuuun Roku (Japan)=노부나가의 야망 - 무장 풍운록 (일본판)
Nobunaga no Yabou - Sengoku Gunyuuden (Japan) (Rev 1)=노부나가의 야망 - 전국 군웅전 (일본판)(개정판 1)
Nobunaga no Yabou - Sengoku Gunyuuden (Japan)=노부나가의 야망 - 전국 군웅전 (일본판)
Nobunaga no Yabou - Zenkoku Ban (Japan) (Rev 1)=노부나가의 야망 - 전국편 (일본판)(개정판 1)
Nobunaga no Yabou - Zenkoku Ban (Japan)=노부나가의 야망 - 전국편 (일본판)
Nobunaga's Ambition (USA)=노부나가의 야망
Nobunaga's Ambition II (USA)=노부나가의 야망 2
North & South (Europe)=남북전쟁
North & South - Wakuwaku Nanboku Sensou (Japan)=남북전쟁 (일본판)
North and South (USA)=남북전쟁
Nuts & Milk (Japan)=너츠 & 밀크
Obake no Q Tarou - Wanwan Panic (Japan)=오바케의 Q태랑 - 왕왕 패닉 (일본판)
Obocchama-kun (Japan)=오보차마 군
Oeka Kids - Anpanman no Hiragana Daisuki (Japan)=오에카 키즈 - 호빵맨의 히라가나 아주좋아
Oeka Kids - Anpanman to Oekaki Shiyou!! (Japan)=오에카 키즈 - 호빵맨과 낙서하자!!
Oishinbo - Kyuukyoku no Menu Sanbon Shoubu (Japan)=맛의 달인 - 궁극의 메뉴 세 개의 승부
Okkotoshi Puzzle - Tonjan! (Japan)=떨어뜨린 퍼즐 - 톤짱!
Olympic IQ (Asia) (Ja) (PAL) (Unl)=올림픽 IQ
Olympus no Tatakai (Japan)=올림푸스의 전투 (일본판)
Onyanko Town (Japan)=오니얀코 타운
Operation Secret Storm (USA) (Unl)=오퍼레이션 시크릿 스톰
Operation Wolf (Europe)=오퍼레이션 울프
Operation Wolf (Japan)=오퍼레이션 울프 (일본판)
Operation Wolf (USA)=오퍼레이션 울프
Orb-3D (USA)=오브 3D
Osomatsu-kun - Back to the Me no Deppa no Maki (Japan)=오소마츠군
Otaku no Seiza - An Adventure in the Otaku Galaxy (Japan)=오타쿠의 성좌 - 오타쿠 은하계 속 모험
Othello (Australia) (HES) (Unl)=오델로
Othello (Japan)=오델로 (일본판)
Othello (USA)=오델로
Outlanders (Japan)=아웃랜더스
Over Horizon (Europe)=오버 호라이즌
Over Horizon (Japan)=오버 호라이즌 (일본판)
Overlord (USA)=오버로드
P'Radikus Conflict (USA) (Unl)=프라디쿠스 컨플릭트
P.O.W. - Prisoners of War (Europe)=P.O.W. - 프리즈너 오브 워
P.O.W. - Prisoners of War (USA)=P.O.W. - 프리즈너 오브 워
Pac-Land (Japan)=팩 랜드
Pac-Land (World) (Namcot Collection, Namco Museum Archives Vol 2)=팩 랜드 (세계판)
Pac-Man (Europe)=팩맨
Pac-Man (Japan) (En) (Rev A)=팩맨 (일본판)(영어)(개정판 A)
Pac-Man (Japan) (En) (Rev B)=팩맨 (일본판)(영어)(개정판 B)
Pac-Man (Japan) (En)=팩맨 (일본판)(영어)
Pac-Man (USA) (Namco)=팩맨 (남코)
Pac-Man (USA) (Tengen) (Unl)=팩맨 (텐젠)(해적판)
Pac-Man (USA) (Tengen)=팩맨 (텐젠)
Pac-Man (USA) (Virtual Console)=팩맨 (버추얼 콘솔)
Pac-Man (World) (Rev A) (Namcot Collection, Namco Museum Archives Vol 1)=팩맨 (세계판)(개정판 A)
Pac-Man Championship Edition (Japan) (En) (Namcot Collection) (Aftermarket)=팩맨 챔피언 에디션 (일본판)(영어)
Pac-Man Championship Edition (USA, Europe) (Namco Museum Archives Vol 1) (Aftermarket)=팩맨 챔피언 에디션
Pac-Mania (USA) (Unl)=팩매니아
Pachi-Slot Adventure 2 - Sorotta-kun no Pachi-Slot Tanteidan (Japan)=파치슬롯 어드벤처 2 - 소롯타 군의 파치슬롯 탐정단
Pachi-Slot Adventure 3 - Bitaoshii 7 Kenzan! (Japan)=파치슬롯 어드벤처 3 - 비타오시 7 등장!
Pachicom (Japan)=파치콤
Pachinko Daisakusen (Japan)=파칭코 대작전
Pachinko Daisakusen 2 (Japan)=파칭코 대작전 2
Pachio-kun 2 (Japan)=파치오 군 2
Pachio-kun 3 (Japan) (Rev A)=파치오 군 3
Pachio-kun 3 (Japan)=파치오 군 3 (일본판)
Pachio-kun 4 (Japan)=파치오 군 4
Pachio-kun 5 (Japan)=파치오 군 5
Pajama Hero - Nemo (Japan)=파자마 히어로 - 네모 (일본판)
Palamedes (Japan)=팔라메데스 (일본판)
Palamedes (USA)=팔라메데스
Palamedes II - Star Twinkle, Hoshi no Mabataki (Japan)=파라메데스 2 -별 초롱
Panic Restaurant (Europe)=패닉 레스토랑
Panic Restaurant (USA)=패닉 레스토랑
Panic! Dizzy (Europe) (Proto)=패닉 디지
Paperboy (Europe)=페이퍼 보이
Paperboy (Japan)=페이퍼 보이 (일본판)
Paperboy (USA)=페이퍼 보이
Paperboy 2 (Europe)=페이퍼 보이 2
Paperboy 2 (USA)=페이퍼 보이 2
Papillon Gals (Japan) (Unl)=파필리온 갈즈 (일본판)(해적판)
Parallel World (Japan)=파라렐 월드
Parasol Henbee (Japan)=파라솔 헨베
Parasol Stars - Rainbow Islands II (Europe)=파라솔 스타 - 레인보우 아일랜드 2
Parasol Stars - The Story of Bubble Bobble III (Europe) (Beta)=파라솔 스타 - 버블 보블 3 이야기 (유럽판)(베타)
Paris-Dakar Rally Special (Japan)=파리 - 다카르 랠리 스페셜
Parodius (Europe) (Beta)=파로디우스 (유럽판)(베타)
Parodius (Europe)=파로디우스
Parodius Da! (Japan)=파로디우스다! - 신화에서 웃음으로 (일본판)
Parody World - Monster Party (Japan) (Proto)=패러디 월드 - 몬스터 파티 (일본판)(시험판)
Peek-A-Boo Poker (USA) (Unl)=피크-A-부 포커
Peepar Time (Japan)=피퍼 타임
Penguin-kun Wars (Japan)=펭귄군 워즈
Pennant League!! - Home Run Nighter (Japan)=페넌트 리그 - 홈런 나이터
Pennant League, The - Home Run Nighter '90 (Japan)=페넌트 리그 - 홈런 나이터 90
Perfect Bowling (Japan)=퍼펙트 볼링
Perman (Japan)=퍼맨
Perman Part 2 - Himitsu Kessha Madoodan o Taose! (Japan)=퍼맨 파트 2 - 비밀결사 마도단을 쓰러뜨려라!
Pescatore (Japan) (Proto)=페스카토레
Pesterminator - The Western Exterminator (USA) (Unl)=페스터미네이터
Phantom Air Mission (Europe)=팬텀 에어 미션
Phantom Fighter (USA)=팬텀 파이터
Pictionary - The Game of Video Quick Draw (USA)=픽셔너리
Pin Bot (Europe)=핀봇
Pin Bot (USA)=핀봇
Pinball (Europe)=핀볼
Pinball (Japan) (En) (GameCube Edition)=핀볼 (일본판)(영어)(게임큐브 버전)
Pinball (Japan, USA) (GameCube Edition)=핀볼 (게임큐브 버전)
Pinball (Japan, USA)=핀볼
Pinball Quest (Australia)=핀볼 퀘스트 (호주판)
Pinball Quest (Japan)=핀볼 퀘스트 (일본판)
Pinball Quest (USA)=핀볼 퀘스트
Pipe Dream (USA)=파이프 드림
Pipe V (Asia) (Ja) (Unl)=파이프 V (아시아판)(일본어)(해적판)
Pipemania (Australia) (HES) (Unl)=파이프매니아
Pirates! (Europe)=해적!
Pirates! (Germany)=해적! (독일판)
Pirates! (USA)=해적!
Pizza Pop! (Japan)=피자 팝!
Plasma Ball (Japan)=플라즈마 볼
Platoon (USA) (Rev 1)=플래툰
Platoon (USA)=플래툰
Playbox BASIC (Japan) (v0.0) (Beta)=플레이박스 베이직 (일본판)(베타)
Pocket Zaurus - Juu Ouken no Nazo (Japan)=포켓 사우르스 - 십왕검의 수수께끼
Poke Block (Asia) (Ja) (Unl)=포크 블록
Poker II (Asia) (Ja) (Unl)=포커 2
Poker III (Asia) (Ja) (Alt 1) (Unl)=포커 3 (아시아판)(일본어)(대체 1)(해적판)
Poker III (Asia) (Ja) (Alt 2) (Unl)=포커 3 (아시아판)(일본어)(대체 2)(해적판)
Poker III (Asia) (Ja) (Unl)=포커 3
Poker Mahjong - Pu Ke Mao Que (Asia) (Ja) (Unl)=포커 마작
Policeman (Spain) (Gluk Video) (Unl)=폴리스맨
Pooyan (Japan)=아기돼지 / 뿌얀
Popeye (Japan)=뽀빠이 (일본판)
Popeye (World) (Rev 1)=뽀빠이
Popeye no Eigo Asobi (Japan)=뽀빠이의 영어 놀이
Popo Team (Asia) (Ja) (Unl)=포포 팀
Porter (Asia) (En) (Unl)=포터
Portopia Renzoku Satsujin Jiken (Japan)=포트피아 연속 살인 사건
Power Blade (Europe)=파워 블레이드
Power Blade (USA)=파워 블레이드
Power Blade 2 (USA)=파워 블레이드 2
Power Blazer (Japan)=파워 블레이져
Power Punch II (USA)=파워 펀치 2
Power Soccer (Japan)=파워 사커
Predator (Australia)=프레데터 (호주판)
Predator (Japan)=프레데터 (일본판)
Predator (USA)=프레데터
President no Sentaku (Japan)=대통령의 선택
Prince of Persia (Europe)=페르시아의 왕자
Prince of Persia (France)=페르시아의 왕자 (프랑스판)
Prince of Persia (Germany)=페르시아의 왕자 (독일판)
Prince of Persia (Spain)=페르시아의 왕자 (스페인판)
Prince of Persia (USA)=페르시아의 왕자
Princess Tomato in the Salad Kingdom (USA) (Beta)=셀러드 왕국 속 토마토 공주 (베타)
Princess Tomato in the Salad Kingdom (USA) (Virtual Console)=셀러드 왕국 속 토마토 공주 (버추얼 콘솔)
Princess Tomato in the Salad Kingdom (USA)=셀러드 왕국 속 토마토 공주
Pro Action Replay (Europe) (v1.0) (Unl)=프로 액션 리플레이 (유럽판)(v1.0)(해적판)
Pro Action Replay (Europe) (v1.2) (Cart Present) (Unl)=프로 액션 리플레이
Pro Action Replay (Europe) (v1.2) (No Cart Present) (Unl)=프로 액션 리플레이 (유럽판)(v1.2)(카트리지없음)(해적판)
Pro Sport Hockey (USA)=프로 스포츠 하키
Pro Wres (Japan) (FamicomBox)=프로 레슬링 (일본판)
Pro Wrestling (Europe)=프로 레슬링
Pro Wrestling (USA) (Rev 1)=프로 레슬링 (개정판 1)
Pro Wrestling (USA)=프로 레슬링
Pro Yakyuu - Family Stadium '87 (Japan)=프로 야구 - 패밀리 스타디움 87
Pro Yakyuu - Family Stadium '88 (Japan)=프로 야구 - 패밀리 스타디움 88
Pro Yakyuu - Family Stadium (Japan)=프로 야구 - 패밀리 스타디움 (일본판)
Pro Yakyuu Satsujin Jiken! (Japan)=프로 야구 살인 사건!
Probotector (Europe)=프로보덱터
Probotector II - Return of the Evil Forces (Europe)=프로보텍터 2 - 악의 세력의 귀환
Project Q (Japan)=프로젝트 Q
Pu Ke Jing Ling (Asia) (Unl)=포커정령 (아시아판)(해적판)
Punch-Out!! (Europe) (Virtual Console)=펀치아웃!! (유럽판)(버추얼 콘솔)
Punch-Out!! (Europe)=펀치아웃!!
Punch-Out!! (Japan) (Gold Edition)=펀치아웃!! (일본판)(골드에디션)
Punch-Out!! (Japan, USA) (Virtual Console)=펀치아웃!! (버추얼 콘솔)
Punch-Out!! (USA)=펀치아웃!!
Punisher, The (USA)=퍼니셔
Puss 'n Boots - Pero's Great Adventure (USA)=장화신은 고양이 - 페로의 대 모험
Puyo Puyo (Japan)=뿌요 뿌요
Puzslot (Japan)=퍼즈롯
Puzzle (Asia) (En) (Idea-Tek) (Unl)=퍼즐 (아시아판)(영어)(해적판)
Puzzle (Spain) (Gluk Video) (Unl)=퍼즐 (스페인판)(글럭 비디오)(해적판)
Puzzle (USA) (Beta) (Unl)=퍼즐 (베타)(해적판)
Puzzle (USA) (Unl)=퍼즐
Puzznic (Europe)=퍼즈닉
Puzznic (Japan)=퍼즈닉 (일본판)
Puzznic (USA)=퍼즈닉
Pyokotan no Daimeiro (Japan)=표코탄의 대미로
Pyramid (USA) (Rev 1) (Unl)=피라미드
Pyramid (USA) (Unl)=피라미드 (해적판)
Pyramid - Cleopatra Kikiippatsu (Japan) (Unl)=피라미드 - 클레오파트라 위기일발 (일본판)(해적판)
Pyramid II (Asia) (Ja) (PAL) (Unl)=피라미드 2
Q Boy (Asia) (Ja) (Unl)=Q 보이
Q-bert (USA)=큐-버트
Qi Wang - Chinese Chess (Asia) (Ja) (Unl)=기왕
QIX (USA)=퀵스
Quarter Back Scramble (Japan)=쿼터백 스크램블
Quarth (Japan)=쿼스
Quattro Adventure (USA) (Unl)=쿼트로 어드벤처
Quattro Arcade (USA) (Unl)=쿼트로 아케이드
Quattro Sports (USA) (Unl)=쿼드로 스포츠 (해적판)
Quinty (Japan) (Namcot Collection)=퀸티 (일본판)
Quinty (Japan)=퀸티 (일본판)
R.B.I. Baseball (USA) (Unl)=RBI 야구 (해적판)
R.B.I. Baseball (USA)=RBI 야구
R.B.I. Baseball 2 (USA) (Unl)=RBI 야구 2
R.B.I. Baseball 3 (USA) (Unl)=RBI 야구 3
R.C. Pro-Am (Europe) (Rev 1)=RC 프로-암
R.C. Pro-Am (Europe)=RC 프로-암 (유럽판)
R.C. Pro-Am (USA) (Rev 1)=RC 프로-암 (개정판 1)
R.C. Pro-Am (USA)=RC 프로-암
R.C. Pro-Am II (Europe)=RC 프로-암 2
R.C. Pro-Am II (USA)=RC 프로-암 2
Racer Mini Yonku - Japan Cup (Japan)=레이서 미니 4구 - 일본 컵
Racermate Challenge II (USA) (v3.11.088) (Unl)=레이서메이트 챌린지 2 (v3.11.088)(해적판)
Racermate Challenge II (USA) (v5.01.033) (Unl)=레이서메이트 챌린지 2 (v5.01.033)(해적판)
Racermate Challenge II (USA) (v6.02.001) (Unl)=레이서메이트 챌린지 2 (해적판)
Racermate Challenge II (USA) (v6.02.002) (Unl)=레이서메이트 챌린지 2 (v6.02.002)(해적판)
Racermate Challenge II (USA) (v9.03.128) (Unl)=레이서메이트 챌린지 2
Racermate Challenge II (USA, Australia) (v3.12.027) (Unl)=레이서메이트 챌린지 2 (미국,호주판)(v3.12.027)(해적판)
Racket Attack (Europe)=라켓 어택
Racket Attack (USA)=라켓 어택
Rackets & Rivals (Europe)=라켓 & 라이벌
Rad Racer (Europe)=라드 레이서
Rad Racer (USA)=라드 레이서
Rad Racer II (USA)=라드 레이서 2
Rad Racket - Deluxe Tennis II (Asia) (En) (Unl)=라트 라켓 - 딜럭스 테니스 2 (아시아판)(영어)(해적판)
Rad Racket - Deluxe Tennis II (USA) (Unl)=라트 라켓 - 딜럭스 테니스 2
Radac Tailor-Made (Japan)=라댁 테일러메이드
Radia Senki - Reimei Hen (Japan)=라디아 전기 - 여명편
Raf World (Japan)=라프 월드 (일본판)
Raid 2020 (USA) (Beta) (1989-12-xx) (Unl)=레이드 2020 (베타)(해적판)
Raid 2020 (USA) (Unl)=레이드 2020
Raid on Bungeling Bay (Japan) (En) (Rev 1)=레이드 온 벙글링 베이 (일본판)(영어)(개정판 1)
Raid on Bungeling Bay (Japan)=레이드 온 벙글링 베이 (일본판)
Raid on Bungeling Bay (USA)=레이드 온 벙글링 베이
Rainbow Islands (USA)=레인보우 아일랜드
Rainbow Islands - Bubble Bobble 2 (Europe)=레인보우 아일랜드 - 버블 보블 2
Rainbow Islands - The Story of Bubble Bobble 2 (Japan) (Sample)=레인보우 아일랜드 - 버블 보블 2 이야기 (일본판)(샘플)
Rainbow Islands - The Story of Bubble Bobble 2 (Japan)=레인보우 아일랜드 - 버블 보블 2 이야기 (일본판)
Rally Bike (USA)=렐리 바이크
Rambo (Japan)=람보 (일본판)
Rambo (USA) (Rev 1)=람보
Rambo (USA)=람보
Rampage (USA)=램페이지
Rampart (Europe) (Jaleco)=램파트
Rampart (Japan) (Konami)=램파트
Rampart (Japan) (Sample) (Konami)=램파트 (일본판)(샘플)(코나미)
Rampart (USA) (Jaleco)=램파트 (잘레코)
Red Arremer II (Japan)=레드 아레머 2 (일본판)
Reigen Doushi (Japan)=영환도사 (일본판)
Remote Control (USA)=리모트 컨트롤
Ren & Stimpy Show, The - Buckeroo$! (USA)=렌과 스팀피 쇼 - 버커루
Renegade (USA) (Virtual Console)=열혈경파 쿠니오군/ 레니게이드 (버추얼 콘솔)
Renegade (USA)=열혈경파 쿠니오군/ 레니게이드
Rescue - The Embassy Mission (Europe)=레스큐 - 대사관 미션
Rescue - The Embassy Mission (USA) (Beta)=레스큐 - 대사관 미션 (베타)
Rescue - The Embassy Mission (USA)=레스큐 - 대사관 미션
Ring King (USA)=링 킹
River City Ransom (USA)=리버 시티 랜섬 / 다운타운 - 열혈물어
Road Fighter (Europe)=로드 파이터
Road Fighter (Japan)=로드 파이터 (일본판)
Road Runner (USA) (Unl)=로드 러너
RoadBlasters (Europe)=로드블래스터즈
RoadBlasters (USA)=로드블래스터즈
Robert Byrne's Pool Challenge (USA) (Proto) (Unl)=로버트 번스 풀 챌린지
Robin Hood - Prince of Thieves (Europe)=로빈 후드 - 도적의 왕자
Robin Hood - Prince of Thieves (Germany)=로빈 후드 - 도적의 왕자 (독일판)
Robin Hood - Prince of Thieves (Spain)=로빈 후드 - 도적의 왕자 (스페인판)
Robin Hood - Prince of Thieves (USA) (Beta) (1991-05-16)=로빈 후드 - 도적의 왕자 (베타)
Robin Hood - Prince of Thieves (USA) (Rev 1)=로빈 후드 - 도적의 왕자 (개정판 1)
Robin Hood - Prince of Thieves (USA)=로빈 후드 - 도적의 왕자
Robo Warrior (Europe)=로보 워리어
Robo Warrior (USA)=로보 워리어
Robocco Wars (Japan)=로보코 워즈
RoboCop (Europe)=로보캅
RoboCop (Japan)=로보캅 (일본판)
RoboCop (USA) (Beta)=로보캅 (베타)
RoboCop (USA)=로보캅
RoboCop 2 (Europe)=로보캅 2
RoboCop 2 (Japan)=로보캅 2 (일본판)
RoboCop 2 (USA) (Rev 1)=로보캅 2 (개정판 1)
RoboCop 2 (USA)=로보캅 2
RoboCop 3 (Europe)=로보캅 3
RoboCop 3 (USA)=로보캅 3
RoboCop versus The Terminator (USA) (Proto)=로보캅 대 터미네이터
Robodemons (USA) (Unl)=로보데몬
Rock 'n' Ball (USA)=록 엔 볼
Rockball (Asia) (Ja) (Unl)=록볼
Rocket Ranger (USA)=로켓 레인져
Rocketeer, The (USA)=로켓티어
Rockin' Kats (Europe)=록킨 캣츠
Rockin' Kats (USA) (Beta) (1991-05-06)=록킨 캣츠 (베타)
Rockin' Kats (USA)=록킨 캣츠
Rockman (Japan) (En)=록맨 (일본판)(영어)
Rockman (Japan) (Virtual Console)=록맨 (일본판)(버추얼 콘솔)
Rockman 2 - Dr. Wily no Nazo (Japan) (Virtual Console)=록맨 2 - 윌리 박사의 수수께끼 (일본판)(버추얼 콘솔)
Rockman 2 - Dr. Wily no Nazo (Japan)=록맨 2 - 윌리 박사의 수수께끼 (일본판)
Rockman 3 - Dr. Wily no Saigo! (Japan) (Virtual Console)=록맨 2 - 윌리 박사의 최후 (일본판)(버추얼 콘솔)
Rockman 3 - Dr. Wily no Saigo! (Japan)=록맨 2 - 윌리 박사의 최후 (일본판)
Rockman 4 - Aratanaru Yabou!! (Japan) (Rev A)=록맨 4 - 새로운 야망!! (일본판)(개정판 A)
Rockman 4 - Aratanaru Yabou!! (Japan) (Virtual Console)=록맨 4 - 새로운 야망!! (일본판)(버추얼 콘솔)
Rockman 4 - Aratanaru Yabou!! (Japan)=록맨 4 - 새로운 야망!! (일본판)
Rockman 5 - Blues no Wana! (Japan) (Virtual Console)=록맨 5 - 블루스의 함정! (일본판)(버추얼 콘솔)
Rockman 5 - Blues no Wana! (Japan)=록맨 5 - 블루스의 함정! (일본판)
Rockman 6 - Shijou Saidai no Tatakai!! (Japan)=록맨 6 - 사상최대의 싸움!! (일본판)
Rocman X (Asia) (Ja) (Unl)=록맨 X
Rodland (Europe)=로드 랜드
Rodland featuring Rit and Tam (Europe) (Beta)=릿과 탬의 로드 랜드 (유럽판)(베타)
Roger Clemens' MVP Baseball (USA)=로저 클레멘스 MVP 베이스볼
Rokudenashi Blues (Japan)=별볼일 없는 블루스
Rollerball (Australia)=롤러볼 (호주판)
Rollerball (Japan)=롤러볼 (일본판)
Rollerball (USA)=롤러볼
Rollerblade Racer (USA)=롤러블레이드 레이서
Rollergames (Europe)=롤러게임스
Rollergames (USA)=롤러게임스
Rolling Thunder (Japan)=롤링 썬더
Rolling Thunder (USA) (Unl)=롤링 썬더 (해적판)
Rolling Thunder (World) (Namcot Collection, Namco Museum Archives Vol 2)=롤링 썬더 (세계판)
Romance of the Three Kingdoms (USA)=삼국지
Romance of the Three Kingdoms II (USA)=삼국지 2
Romancia (Japan)=로맨시아
Roundball - 2-on-2 Challenge (Europe)=라운드 볼 - 2대2 챌린지
Roundball - 2-on-2 Challenge (USA)=라운드 볼 - 2대2 챌린지
Route-16 Turbo (Japan)=루트-16 터보
Royal Blood (Japan)=로열 블러드 (일본판)
RPG Jinsei Game (Japan)=RPG 인생 게임
Rumble Station - 15 in 1 (USA) (Unl)=럼블 스테이션 - 15합팩
Rush'n Attack (Europe)=러쉬 앤 어택
Rush'n Attack (USA)=러쉬 앤 어택
Rygar (Europe)=아르고스의 전사 / 라이거
Rygar (USA) (Rev 1)=아르고스의 전사 / 라이거 (개정판 1)
Rygar (USA)=아르고스의 전사 / 라이거
S.C.A.T. - Special Cybernetic Attack Team (USA) (Beta)=SCAT - 스페셜 사이버네틱 어택 팀 (베타)
S.C.A.T. - Special Cybernetic Attack Team (USA)=SCAT - 스페셜 사이버네틱 어택 팀
S.C.A.T. - Special Cybernetic Attack Team (USA, Europe) (Virtual Console)=SCAT - 스페셜 사이버네틱 어택 팀 (미국,유럽판)(버추얼 콘솔)
Saint Seiya - Ougon Densetsu (Japan)=세인트 세이야 - 황금 전설
Saint Seiya - Ougon Densetsu Kanketsu Hen (Japan) (Beta)=세인트 세이야 - 황금 전설 완결편 (일본판)(베타)
Saint Seiya - Ougon Densetsu Kanketsu Hen (Japan)=세인트 세이야 - 황금 전설 완결편
Saiyuuki World (Japan)=서유기 월드
Saiyuuki World 2 - Tenjoukai no Majin (Japan)=서유기 월드 2 - 천상계의 마인 (일본판)
Sakigake!! Otoko Juku - Shippuu Ichi Gou Sei (Japan)=돌격!! 남자훈련소 - 질풍1호생
Salad no Kuni no Tomato Hime (Japan) (Virtual Console)=셀러드 왕국의 토마토 공주 (일본판)(버추얼 콘솔)
Salad no Kuni no Tomato Hime (Japan)=셀러드 왕국의 토마토 공주 (일본판)
Salamander (Japan)=사라만다 (일본판)
Samsara Naga (Japan)=산사라 나가
San Guo Zhi - Qun Xiong Zheng Ba (Asia) (Ja) (Unl)=삼국지 - 군웅쟁패
San Guo Zhong Lie Zhuan (Asia) (Unl)=삼국충열전
Sanada Juu Yuushi (Japan)=사나다 십용사
Sangokushi (Japan) (Rev 1)=삼국지 (일본판)(개정판 1)
Sangokushi (Japan)=삼국지 (일본판)
Sangokushi - Chuugen no Hasha (Japan)=삼국지 - 중원의 패자
Sangokushi II (Japan) (Rev 1)=삼국지 2 (일본판)(개정판 1)
Sangokushi II (Japan)=삼국지 2 (일본판)
Sangokushi II - Haou no Tairiku (Japan)=삼국지 2 - 패왕의 대륙
Sanguo Chunqiu - Sichuan Sheng (Asia) (Unl)=삼국춘추 - 사천성
Sanma no Meitantei (Japan)=명탐정 산마
Sanrio Carnival (Japan)=산리오 카니발
Sanrio Carnival 2 (Japan)=산리오 카니발 2
Sanrio Cup - Pon Pon Volley (Japan)=산리오 컵 - 퐁 퐁 배구
Sansuu 1 Nen - Keisan Game (Japan)=산수 1 학년 - 계산게임
Sansuu 2 Nen - Keisan Game (Japan)=산수 2 학년 - 계산게임
Sansuu 3 Nen - Keisan Game (Japan)=산수 3 학년 - 계산게임
Sansuu 4 Nen - Keisan Game (Japan) (Beta)=산수 4 학년 - 계산게임 (일본판)(베타)
Sansuu 4 Nen - Keisan Game (Japan)=산수 4 학년 - 계산게임
Sansuu 5 & 6 Nen - Keisan Game (Japan) (Beta)=산수 5 & 6 학년 - 계산게임 (일본판)(베타)
Sansuu 5 & 6 Nen - Keisan Game (Japan)=산수 5 & 6 학년 - 계산게임
Satomi Hakkenden (Japan)=사토미 팔견전
Satsui no Kaisou - Soft House Renzoku Satsujin Jiken (Japan)=살의의 계층 - 소프트 하우스 살인 사건
Scarabeus (USA) (Sample)=스카라베우스
SD Battle Oozumou - Heisei Hero Basho (Japan)=SD 배틀 대스모 - 헤이세이 히어로 장소
SD Gundam - Gachapon Senshi 2 - Capsule Senki (Japan)=SD 건담 - 가챠폰 전사 2 - 캡슐 전기
SD Gundam - Gachapon Senshi 3 - Eiyuu Senki (Japan)=SD 건담 - 가챠폰 전사 3 - 영웅 전기
SD Gundam - Gachapon Senshi 4 - NewType Story (Japan)=SD 건담 - 가챠폰 전사 4 - 뉴 타입 스토리
SD Gundam - Gachapon Senshi 5 - Battle of Universal Century (Japan)=SD 건담 - 가챠폰 전사 5 - 배틀 오브 유니버셜 센트리
SD Gundam Gaiden - Knight Gundam Monogatari (Japan) (Rev 1)=SD 건담 외전 - 나이트 건담 이야기
SD Gundam Gaiden - Knight Gundam Monogatari (Japan)=SD 건담 외전 - 나이트 건담 이야기 (일본판)
SD Gundam Gaiden - Knight Gundam Monogatari 2 - Hikari no Knight (Japan)=SD 건담 외전 - 나이트 건담 이야기 2 - 빛의 기사
SD Gundam Gaiden - Knight Gundam Monogatari 3 - Densetsu no Kishi Dan (Japan)=SD 건담 외전 - 나이트 건담 이야기 3 - 전설의 기사단
SD Hero Soukessen - Taose! Aku no Gundan (Japan)=SD 히어로 총결전 - 쓰러뜨려라! 악의 군단
SD Keiji - Blader (Japan)=SD 형사 - 블레이더
SD Sengoku Bushou Retsuden (Japan)=SD전국 무장 열전 - 열화와 같이 천하를 뺏어라!
Secret Scout in the Temple of Demise (USA) (Beta) (Unl)=비밀 정찰 (베타)(해적판)
Secret Scout in the Temple of Demise (USA) (Unl)=비밀 정찰
Secret Ties (USA) (Proto)=시크릿 타이즈
Section-Z (Europe)=섹션 Z
Section-Z (USA)=섹션 Z
Seicross (Japan) (Rev 1)=세이크로스 (일본판)(개정판 1)
Seicross (Japan) (Virtual Console)=세이크로스 (일본판)(버추얼 콘솔)
Seicross (Japan)=세이크로스 (일본판)
Seicross (USA)=세이크로스
Seikima II - Akuma no Gyakushuu! (Japan)=성걸마 2 - 악마의 역습
Seirei Densetsu Lickle (Japan)=성령 전설 리클 (일본판)
Seirei Gari (Japan)=성령사냥
Seiryaku Simulation - Inbou no Wakusei - Shancara (Japan)=정략 시뮬레이션 - 음모의 혹성 - 샨카라
Sekiryuuou (Japan)=적룡왕
Senjou no Ookami (Japan)=전장의 이리 / 코만도 (일본판)
Sensha Senryaku - Sabaku no Kitsune (Japan)=전차 전략 - 사막의 여우 (일본판)
Sesame Street - 123 (USA)=세서미 스트리트 - 123
Sesame Street - ABC & 123 (USA)=세서미 스트리트 - ABC & 123
Sesame Street - ABC (USA)=세서미 스트리트 - ABC
Sesame Street - Big Bird's Hide & Speak (USA)=세서미 스트리트 - 빅 버드스 하이드 & 스피크
Sesame Street - Countdown (USA)=세서미 스트리트 - 카운트 다운
Shadow Brain (Japan)=쉐도우 브레인
Shadow of the Ninja (USA)=쉐도우 오브 더 닌자
Shadow of the Ninja (USA, Europe) (Virtual Console)=쉐도우 오브 더 닌자 (미국,유럽판)(버추얼 콘솔)
Shadow Warriors - Ninja Gaiden (Europe) (Virtual Console)=닌자 용검전 / 쉐도우 워리어즈 (유럽판)(버추얼 콘솔)
Shadow Warriors - Ninja Gaiden (Europe)=닌자 용검전 / 쉐도우 워리어즈
Shadow Warriors II - Ninja Gaiden II (Europe)=닌자 용검전 2 / 쉐도우 워리어즈 2
Shadowgate (Europe)=쉐도우 게이트
Shadowgate (France)=쉐도우 게이트 (프랑스판)
Shadowgate (Germany)=쉐도우 게이트 (독일판)
Shadowgate (Japan)=쉐도우 게이트 (일본판)
Shadowgate (Sweden)=쉐도우 게이트 (스웨덴판)
Shadowgate (USA)=쉐도우 게이트
Shaffle Fight (Japan)=셔플 파이트
Shang Gu Shen Jian (Asia) (Unl)=상고신검 (아시아판)(해적판)
Shanghai (Japan) (Sample)=상하이 (일본판)(샘플)
Shanghai (Japan)=상하이
Shanghai II (Japan)=상하이 2
Shatterhand (Europe)=셔터헨드
Shatterhand (USA) (Beta)=셔터헨드 (베타)
Shatterhand (USA)=셔터헨드
Shen Tan Ke Nan (Asia) (Unl)=신탄가남 (아시아판)(해적판)
Sheng Huo Lie Zhuan (Asia) (Ja) (Unl)=성화열전
Sherlock Holmes - Hakushaku Reijou Yuukai Jiken (Japan)=셜록 홈즈 - 백작 딸 유괴 사건
Shikinjou (Japan)=자금성
Shin 4 Nin Uchi Mahjong - Yakuman Tengoku (Japan)=신 4인 마작 - 역만천국
Shin Jinrui - The New Type (Japan)=신인류 - 더 뉴타입 (일본판)
Shin Moero!! Pro Yakyuu (Japan)=신 불타라!! 프로야구
Shin Satomi Hakken-Den - Hikari to Yami no Tatakai (Japan)=신 사토미 팔견-전 - 빛과 어둠의 싸움
Shingen the Ruler (USA)=신겐 더 룰러
Shinobi (USA) (Unl)=시노비
Shinsenden (Japan)=신선전
Shisen Mahjong - Seifuku Hen (Japan) (Unl)=명천 마작 - 제복 편
Shisen Mahjong 2 (Asia) (Unl)=명천 마작 2 (아시아판)(해적판)
Shockwave (USA) (Unl)=쇼크 웨이브
Shogun (Japan)=쇼군
Shooting Range (USA)=슈팅 레인지
Short Order + Eggsplode! (USA)=숏 오더 - 에그 스플로드!
Shougi Meikan '92 (Japan)=장기 명감 92
Shougi Meikan '93 (Japan)=장기 명감 93
Shoukoushi Ceddie (Japan)=소공자 세디
Shounen Ashibe - Nepal Daibouken no Maki (Japan)=소년 아시베 - 네팔 대모험 편
Shuang Xiang Pao (Asia) (Ja) (Unl)=쌍향포
Shuang Ying (Asia) (Ja) (Unl)=쌍응 (아시아판)(일본어)(해적판)
Shufflepuck Cafe (Japan)=셔플 퍽 카페
Shui Guo Li (Asia) (Unl)=수과리 (아시아판)(해적판)
Side Pocket (Europe)=사이드 포켓
Side Pocket (Japan)=사이드 포켓 (일본판)
Side Pocket (USA)=사이드 포켓
Sidewinder (Asia) (Ja) (PAL) (Unl)=사이드와인더 (아시아판)(일본어)(PAL)(해적판)
Sidewinder (Australia) (Unl)=사이드와인더 (호주판)(해적판)
Silent Assault (Asia) (Ja) (PAL) (Unl)=사일런트 어썰트 (아시아판)(일본어)(PAL)(해적판)
Silent Assault (USA) (Unl)=사일런트 어썰트
Silent Service (Europe)=사일런트 서비스
Silent Service (USA) (Rev 1)=사일런트 서비스 (개정판 1)
Silent Service (USA)=사일런트 서비스
Silk Worm (USA)=실크 웜
Silva Saga (Japan)=실버 사가
Silver Eagle (Asia) (Ja) (PAL) (Unl)=실버 이글
Silver Surfer (USA)=실버 서퍼
SimCity (USA) (Proto)=심시티
Simpsons, The - Bart vs. the Space Mutants (Europe)=심슨 가족 - 바트 대 우주 돌연변이
Simpsons, The - Bart vs. the Space Mutants (USA) (Rev 1)=심슨 가족 - 바트 대 우주 돌연변이 (개정판 1)
Simpsons, The - Bart vs. the Space Mutants (USA)=심슨 가족 - 바트 대 우주 돌연변이
Simpsons, The - Bart vs. the World (Europe)=심슨 가족 - 바트 vs 월드
Simpsons, The - Bart vs. the World (USA)=심슨 가족 - 바트 vs 월드
Simpsons, The - Bartman Meets Radioactive Man (Europe)=심슨 가족 - 바트맨 미츠 레디오액티드 맨
Simpsons, The - Bartman Meets Radioactive Man (USA) (Beta)=심슨 가족 - 바트맨 미츠 레디오액티드 맨 (베타)
Simpsons, The - Bartman Meets Radioactive Man (USA)=심슨 가족 - 바트맨 미츠 레디오액티드 맨
Skate Boy (Spain) (Gluk Video) (Unl)=스케이트 보이
Skate or Die (Europe)=스케이트냐 죽음이냐
Skate or Die (USA)=스케이트냐 죽음이냐
Skate or Die 2 - The Search for Double Trouble (USA)=스케이트냐 죽음이냐 2 - 이중 문제를 찾아라
Ski or Die (Europe)=스키냐 죽음이냐
Ski or Die (USA)=스키냐 죽음이냐
Skull & Crossbones (Korea) (Unl)=스컬 & 크로스본즈 (한국판)(해적판)
Skull & Crossbones (USA) (Unl)=스컬 & 크로스본즈
Sky Destroyer (Japan)=스카이 디스트로이어
Sky Kid (Japan) (Virtual Console)=스카이 키드 (일본판)(버추얼 콘솔)
Sky Kid (Japan)=스카이 키드 (일본판)
Sky Kid (USA)=스카이 키드
Sky Kid (World) (Namcot Collection, Namco Museum Archives Vol 1)=스카이 키드 (세계판)
Sky Shark (USA)=스카이 샤크
Slalom (Europe)=슬랄롬
Slalom (USA)=슬랄롬
Smash T.V. (Europe)=스매시 TV
Smash T.V. (USA)=스매시 TV
Smurfs, The (Europe) (En,Fr,De,Es)=스머프
Snake Rattle n Roll (Europe)=스네이크 래틀 엔 롤
Snake Rattle n Roll (USA)=스네이크 래틀 엔 롤
Snake's Revenge (Europe)=스네이크의 복수
Snake's Revenge (USA)=스네이크의 복수
Snoopy's Silly Sports Spectacular! (USA)=스누피의 어이없이 장대한 스포츠
Snow Bros. (Japan)=스노우 브라더스 (일본판)
Snow Brothers (Europe)=스노우 브라더스
Snow Brothers (USA)=스노우 브라더스
Snowboard Challenge (Europe)=스노우보드 챌린지
Soap Panic (Japan) (Unl)=소프 패닉 (일본판)(해적판)
Soccer (Europe)=사커
Soccer (Japan, USA)=사커
Soccer League - Winner's Cup (Japan)=사커 리그 - 위너스 컵
Softball Tengoku (Japan)=소프트볼 천국 (일본판)
Solar Jetman - Hunt for the Golden Warpship (Europe)=솔라 제트맨 - 금빛 워프쉽을 위한 사냥
Solar Jetman - Hunt for the Golden Warpship (USA)=솔라 제트맨 - 금빛 워프쉽을 위한 사냥
Solitaire (USA) (Unl)=솔레테어
Solomon no Kagi (Japan)=솔로몬의 열쇠 (일본판)
Solomon no Kagi 2 - Coolmintou Kyuushutsu Sakusen (Japan)=솔로몬의 열쇠 2 - 쿠르민섬 구출작전 (일본판)
Solomon's Key (Europe)=솔로몬의 열쇠
Solomon's Key (USA)=솔로몬의 열쇠
Solomon's Key 2 (Europe)=솔로몬의 열쇠 2
Solomon's Key 2 (USA) (Beta)=솔로몬의 열쇠 2 (베타)
Solstice (Japan)=솔스티스 - 3차원 미궁의 괴수 (일본판)
Solstice - The Quest for the Staff of Demnos (Europe)=솔스티스 - 퀘스트 포 스태프 오브 데몬
Solstice - The Quest for the Staff of Demnos (USA) (Beta)=솔스티스 - 퀘스트 포 스태프 오브 데몬 (베타)
Solstice - The Quest for the Staff of Demnos (USA)=솔스티스 - 퀘스트 포 스태프 오브 데몬
Son Son (Japan)=손 손
Soreike! Anpanman - Minna de Hiking Game! (Japan)=그대로 가라!호빵맨 - 모두 하이킹 게임!
Sou Setsu Ryuu (Japan) (Beta)=쌍절룡 (일본판)(베타)
Sou Setsu Ryuu II - The Revenge (Japan) (Sample)=쌍절룡 2 - 복수 (일본판)(샘플)
Sou Setsu Ryuu II - The Revenge (Japan)=쌍절룡 2 - 복수 (일본판)
Sou Setsu Ryuu III - The Rosetta Stone (Japan)=쌍절룔 3 - 로제타 스톤 (일본판)
Space Harrier (Japan)=스페이스 해리어
Space Hunter (Japan)=스페이스 헌터
Space Invaders (Japan)=스페이스 인베이더
Space Shadow (Japan)=스페이스 쉐도우
Space Shuttle Project (USA)=스페이스 셔틀 프로젝트
Spartan X (Japan)=스파르탄 X / 이소룡 (일본판)
Spartan X 2 (Japan)=스파르탄 X 2
Spelunker (Japan) (Virtual Console)=스페랑카 (일본판)(버추얼 콘솔)
Spelunker (Japan)=스페랑카 (일본판)
Spelunker (USA)=스페랑카
Spelunker (USA, Europe) (Virtual Console)=스페랑카 (미국,유럽판)(버추얼 콘솔)
Spelunker II - Yuusha e no Chousen (Japan)=스페랑카 2 - 용사에게 도전
Spider-Man - Return of the Sinister Six (Europe)=스파이더맨 - 시니스터 식스의 귀환
Spider-Man - Return of the Sinister Six (USA)=스파이더맨 - 시니스터 식스의 귀환
Spiritual Warfare (USA) (Beta) (Unl)=스피리추얼 워페어 (베타)(해적판)
Spiritual Warfare (USA) (v5.1) (Unl)=스피리추얼 워페어 (v5.1)(해적판)
Spiritual Warfare (USA) (v6.0) (Unl)=스피리추얼 워페어 (v6.0)(해적판)
Spiritual Warfare (USA) (v6.1) (Unl)=스피리추얼 워페어
Splatterhouse - Wanpaku Graffiti (Japan)=스플래터 하우스 - 개구쟁이 그래피티
Splatterhouse - Wanpaku Graffiti (World) (Namcot Collection, Namco Museum Archives Vol 1)=스플래터 하우스 - 개구쟁이 그래피티 (세계판)
Spot (Japan)=스팟 (일본판)
Spot - The Video Game (USA)=스팟
Spy Hunter (USA)=스파이 헌터
Spy vs Spy (Europe)=스파이 vs 스파이
Spy vs Spy (Japan)=스파이 vs 스파이 (일본판)
Spy vs Spy (USA)=스파이 vs 스파이
Sqoon (Japan) (Rev A)=스쿤 (일본판)(개정판 A)
Sqoon (Japan)=스쿤 (일본판)
Sqoon (USA)=스쿤
Square Deal (Japan) (Sample)=스퀘어 딜 (일본판)(샘플)
Square no Tom Sawyer (Japan)=스퀘어 의 톰 소여
Squashed (USA) (Proto)=스쿼시드 (시험판)
Stack-Up ~ Block (World)=스택-업 - 로봇 블록
Stadium Events (Europe)=스타디움 이벤츠
Stadium Events (USA)=스타디움 이벤츠
Stanley - The Search for Dr. Livingston (USA)=스텐리 - 리빙스턴 박사의 조사
Star Force (Europe)=스타 포스
Star Force (Japan)=스타 포스 (일본판)
Star Force (USA) (Beta)=스타 포스 (베타)
Star Force (USA)=스타 포스
Star Gate (Japan)=스타 게이트 (일본판)
Star Luster (Japan) (Namcot Collection)=스타 러스터 (일본판)
Star Luster (Japan) (Virtual Console)=스타 러스터 (일본판)(버추얼 콘솔)
Star Luster (Japan)=스타 러스터
Star Soldier (Japan) (Sample)=스타 솔져 (일본판)(샘플)
Star Soldier (Japan)=스타 솔져 (일본판)
Star Soldier (USA)=스타 솔져
Star Trek - 25th Anniversary (Germany)=스타 트렉 - 25주년 기념판 (독일판)
Star Trek - 25th Anniversary (USA)=스타 트렉 - 25주년 기념판
Star Trek - The Next Generation (USA)=스타 트랙 - 더 넥스트 제네레이션
Star Trek V - The Final Frontier (USA) (Proto)=스타 트렉 5 - 마지막 개척지
Star Voyager (USA)=스타 보이져
Star Wars (Europe)=스타 워즈
Star Wars (Japan) (Namco)=스타 워즈
Star Wars (Japan) (Victor)=스타 워즈 (일본판)(빅터)
Star Wars (USA) (Beta)=스타 워즈 (베타)
Star Wars (USA)=스타 워즈
Star Wars - The Empire Strikes Back (Europe)=스타 워즈 - 제국의 역습
Star Wars - The Empire Strikes Back (Japan)=스타 워즈 - 제국의 역습 (일본판)
Star Wars - The Empire Strikes Back (USA) (Beta)=스타 워즈 - 제국의 역습 (베타)
Star Wars - The Empire Strikes Back (USA)=스타 워즈 - 제국의 역습
Starship Hector (USA)=헥터 87
StarTropics (Europe) (Virtual Console)=스타트로픽스 (유럽판)(버추얼 콘솔)
StarTropics (Europe)=스타트로픽스
StarTropics (USA) (Virtual Console)=스타트로픽스 (버추얼 콘솔)
StarTropics (USA)=스타트로픽스
Stealth ATF (Europe)=스텔스 ATF
Stealth ATF (USA)=스텔스 ATF
Sted - Iseki Wakusei no Yabou (Japan)=스테드 - 유적혹성의 야망
Steins;Gate (USA) (Nintendo Switch)=슈타인즈 게이트
Stick Hunter - Exciting Ice Hockey (Japan)=스틱 헌터 - 익사이팅 아이스 하키
Stinger (USA) (Virtual Console)=스팅거 (버추얼 콘솔)
Stinger (USA)=스팅거
Strategist (Asia) (Ja) (NTSC) (Unl)=스트라티지스트
Strategist (Asia) (Ja) (PAL) (Unl)=스트라티지스트 (아시아판)(일본어)(PAL)(해적판)
Street Cop (USA)=스트리트 캅
Street Fighter 2010 - The Final Fight (USA)=스트리트 파이터 2010 - 최후의 싸움
Street Gangs (Europe) (Virtual Console)=스트리트 갱즈 (유럽판)(버추얼 콘솔)
Street Gangs (Europe)=스트리트 갱즈
Street Heroes (Asia) (Ja) (Unl)=스트리트 히어로즈
Strider (USA)=스트라이더
Strider Hiryu (Japan) (Proto)=스트라이더 비룡 (일본판)(시험판)
Strike Wolf (Asia) (Unl)=스트라이크 울프
Stunt Kids (USA) (Unl)=스턴트 키즈
Sugoro Quest - Dice no Senshitachi (Japan) (Virtual Console)=스고로쿠 퀘스트 - 주사위의 전사들 (일본판)(버추얼 콘솔)
Sugoro Quest - Dice no Senshitachi (Japan)=스고로쿠 퀘스트 - 주사위의 전사들
Suikoden - Tenmei no Chikai (Japan)=수호전 - 천명 의 맹세 (일본판)
Sukeban Deka III (Japan)=스케반 형사 3
Summer Carnival '92 - Recca (Japan)=서머 카니발 92 - 열화
Sunday Funday - The Ride (USA) (Unl)=일요일은 즐거워
Sunman (Europe) (Proto)=선맨
Super 190-in-1 (Asia) (En) (Unl) (Pirate)=슈퍼 190합팩
Super Adventure Quests (Europe) (Unl)=슈퍼 어드벤처 퀘스트 (유럽판)(해적판)
Super Arabian (Japan)=슈퍼 아라비안
Super Black Onyx (Japan)=슈퍼 블랙 오닉스
Super C (USA)=슈퍼 C
Super Cars (USA)=슈퍼 카즈
Super Cartridge Ver 1 - 4 in 1 (Asia) (Ja) (Unl)=슈퍼 카트리지 Ver 1 - 4 합팩
Super Cartridge Ver 2 - 10 in 1 (Asia) (Ja) (Unl)=슈퍼 카트리지 Ver 2 - 10 합팩
Super Cartridge Ver 3 - 8 in 1 (Asia) (Ja) (Unl)=슈퍼 카트리지 Ver 3 - 8 합팩
Super Cartridge Ver 4 - 6 in 1 (Asia) (Ja) (Unl)=슈퍼 카트리지 Ver 4 - 6 합팩
Super Cartridge Ver 5 - 7 in 1 (Asia) (Ja) (Unl)=슈퍼 카트리지 Ver 5 - 7 합팩
Super Cartridge Ver 6 - 6 in 1 (Asia) (Ja) (Unl)=슈퍼 카트리지 Ver 6 - 6 합팩
Super Cartridge Ver 7 - 4 in 1 (Asia) (Ja) (Unl)=슈퍼 카트리지 Ver 7 - 4 합팩
Super Cartridge Ver 8 - 4 in 1 (Asia) (Ja) (Unl)=슈퍼 카트리지 Ver 8 - 4 합팩
Super Cartridge Ver 9 - 3 in 1 (Asia) (Ja) (Unl)=슈퍼 카트리지 Ver 9 - 3 합팩
Super Chinese (Japan)=슈퍼 차이니즈 (일본판)
Super Chinese 2 - Dragon Kid (Japan) (Virtual Console)=슈퍼 차이니즈 2 - 드래곤 키드 (일본판)(버추얼 콘솔)
Super Chinese 2 - Dragon Kid (Japan)=슈퍼 차이니즈 2 - 드래곤 키드 (일본판)
Super Chinese 3 (Japan)=슈퍼 차이니즈 3
Super Contra (Japan)=슈퍼 혼두라 (일본판)
Super Dodge Ball (USA) (Virtual Console)=열혈고교 피구부 (버추얼 콘솔)
Super Dodge Ball (USA)=열혈고교 피구부
Super Dyna'mix Badminton (Japan)=슈퍼 다이나믹스 배드민턴
Super Glove Ball (USA)=슈퍼 글로브
Super Jeopardy! (USA)=슈퍼 재퍼디!
Super Mario Bros. (Europe) (PAL-SM)=슈퍼 마리오 브라더스
Super Mario Bros. (World) (HVC-SM)=슈퍼 마리오 브라더스 (세계판)
Super Mario Bros. + Duck Hunt (Europe)=슈퍼 마리오 + 오리 사냥
Super Mario Bros. + Duck Hunt (USA)=슈퍼 마리오 + 오리 사냥
Super Mario Bros. + Duck Hunt + World Class Track Meet (USA) (Rev 1)=슈퍼 마리오 + 오리 사냥 + 트랙 미트
Super Mario Bros. + Duck Hunt + World Class Track Meet (USA)=슈퍼 마리오 + 오리 사냥 + 트랙 미트
Super Mario Bros. + Tetris + Nintendo World Cup (Europe) (Rev 1)=슈퍼 마리오 + 테트리스 + 닌텐도 월드 컵
Super Mario Bros. + Tetris + Nintendo World Cup (Europe)=슈퍼 마리오 + 테트리스 + 닌텐도 월드 컵 (유럽판)
Super Mario Bros. - 25th Anniversary (Australia) (Virtual Console)=슈퍼 마리오 브라더스 - 25주년 기념 (호주판)(버추얼 콘솔)
Super Mario Bros. - 25th Anniversary (Japan) (En) (Virtual Console)=슈퍼 마리오 브라더스 - 25주년 기념 (일본판)(영어)(버추얼 콘솔)
Super Mario Bros. 2 (Europe) (Virtual Console)=슈퍼 마리오 브라더스 2 (유럽판)(버추얼 콘솔)
Super Mario Bros. 2 (Europe)=슈퍼 마리오 브라더스 2
Super Mario Bros. 2 (Japan) (Virtual Console)=슈퍼 마리오 브라더스 2 (일본판)(버추얼 콘솔)
Super Mario Bros. 2 (USA) (Beta)=슈퍼 마리오 브라더스 2 (베타)
Super Mario Bros. 2 (USA) (Rev 1) (Virtual Console)=슈퍼 마리오 브라더스 2 (개정판 1)(버추얼 콘솔)
Super Mario Bros. 2 (USA) (Rev 1)=슈퍼 마리오 브라더스 2 (개정판 1)
Super Mario Bros. 2 (USA)=슈퍼 마리오 브라더스 2
Super Mario Bros. 3 (Europe) (Virtual Console)=슈퍼 마리오 브라더스 3 (유럽판)(버추얼 콘솔)
Super Mario Bros. 3 (Europe)=슈퍼 마리오 브라더스 3
Super Mario Bros. 3 (Japan) (Rev 1) (Virtual Console)=슈퍼 마리오 브라더스 3 (일본판)(개정판 1)(버추얼 콘솔)
Super Mario Bros. 3 (Japan) (Rev 1)=슈퍼 마리오 브라더스 3 (일본판)(개정판 1)
Super Mario Bros. 3 (Japan)=슈퍼 마리오 브라더스 3 (일본판)
Super Mario Bros. 3 (USA) (Rev 1) (Virtual Console)=슈퍼 마리오 브라더스 3 (개정판 1)(버추얼 콘솔)
Super Mario Bros. 3 (USA) (Rev 1)=슈퍼 마리오 브라더스 3 (개정판 1)
Super Mario Bros. 3 (USA)=슈퍼 마리오 브라더스 3
Super Mario USA (Japan)=슈퍼 마리오 USA (일본판)
Super Mogura Tataki!! - Pokkun Mogurar (Japan)=슈퍼 두더지 잡기!! - 포큰 모구라
Super Momotarou Dentetsu (Japan)=슈퍼 도태랑 전철
Super Pang (Asia) (Ja) (PAL) (Unl)=슈퍼 팡
Super Pang II (Asia) (Ja) (Unl)=슈퍼 팡 2
Super Pinball (Japan) (Beta)=슈퍼 핀볼 (일본판)(베타)
Super Pinball (Japan)=슈퍼 핀볼
Super Pitfall (Japan)=슈퍼 핏폴 (일본판)
Super Pitfall (USA)=슈퍼 핏폴
Super Pitfall II (USA) (Proto)=슈퍼 핏폴 2 (시험판)
Super Real Baseball '88 (Japan)=슈퍼 리얼 베이스볼 88
Super Rugby (Japan)=슈퍼 럭비
Super Spike V'Ball (Europe)=슈퍼 스파이크 발리볼
Super Spike V'Ball (USA)=슈퍼 스파이크 발리볼
Super Spike V'Ball + Nintendo World Cup (USA)=슈퍼 스파이크 발리볼 - 닌텐도 월드컵
Super Sports Challenge (Europe) (Plug-Thru Cart) (Unl)=슈퍼 스포츠 첼린지 (유럽판)(플러그 스루 카트)(해적판)
Super Sports Challenge (Europe) (Unl)=슈퍼 스포츠 첼린지
Super Sprint (Japan)=슈퍼 스프린트
Super Sprint (USA) (Unl)=슈퍼 스프린트 (해적판)
Super Spy Hunter (Europe)=슈퍼 스파이 헌터
Super Spy Hunter (USA)=슈퍼 스파이 헌터
Super Star Force (Japan)=슈퍼 스타 포스 - 시공력의 비밀
Super Team Games (USA)=슈퍼 팀 게임즈
Super Turrican (Europe)=슈퍼 터리칸
Super Xevious - Gump no Nazo (Japan)=슈퍼 제비우스 - 감프의 수수께끼
Super Xevious - Gump no Nazo (USA, Europe) (Namco Museum Archives Vol 2)=슈퍼 제비우스 - 감프의 수수께끼 (미국,유럽판)
Superman (Japan) (Beta)=슈퍼맨 (일본판)(베타)
Superman (Japan)=슈퍼맨 (일본판)
Superman (USA) (Kemco)=슈퍼맨
Superman (USA) (Proto) (Sunsoft)=슈퍼맨 (시험판)(선소프트)
Superstar Pro Wrestling (Japan)=슈퍼스타 프로 레슬링 (일본판)
Swamp Thing (Europe)=스웜프 띵
Swamp Thing (USA)=스웜프 띵
SWAT - Special Weapons and Tactics (Japan)=스와트 - 특수 무기들 과 전술
Sweet Home (Japan) (Sample)=스위트 홈 (일본판)(샘플)
Sweet Home (Japan)=스위트 홈
Sword Master (Europe)=소드 마스터
Sword Master (Japan)=소드 마스터 (일본판)
Sword Master (USA)=소드 마스터
Swords and Serpents (Europe)=소드 엔 서펜트
Swords and Serpents (France)=소드 엔 서펜트 (프랑스판)
Swords and Serpents (USA)=소드 엔 서펜트
Taan Hak Fung Wan - King Tank (Asia) (Unl)=탄극풍운
Taboo - The Sixth Sense (USA) (Rev 1)=테부 - 육감
Taboo - The Sixth Sense (USA)=테부 - 육감
Tag Team Pro-Wrestling (Japan)=태그 팀 프로 레슬링 (일본판)
Tag Team Pro-Wrestling Special (Japan) (Sample)=태그 팀 프로 레슬링 스페셜 (일본판)(샘플)
Tag Team Wrestling (USA)=태그 팀 레슬링
Tagin' Dragon (USA) (Unl)=테긴 드래곤
Taito Basketball (Japan)=타이토 바스켓볼 (일본판)
Taito Chase H.Q. (Japan)=타이토 체이스 H.Q.
Taito Grand Prix - Eikou e no License (Japan)=타이토 그랑프리 - 영광의 라이센스
Taiwan Mahjong - Tai Wan Ma Que 16 (Asia) (Ja) (Unl)=대만 마작
Taiwan Mahjong 2 (Asia) (Ja) (Unl)=대만 마작 2
Taiyou no Shinden (Japan)=태양의 신전 - 아즈테카2 (일본판)
Taiyou no Yuusha - Fighbird (Japan)=태양의 용사 파이버드
Takahashi Meijin no Bouken-jima (Japan)=타카하시 명인의 모험도 (일본판)
Takahashi Meijin no Bouken-jima II (Japan)=타카하시 명인의 모험도 2 (일본판)
Takahashi Meijin no Bouken-jima III (Japan)=타카하시 명인의 모험도 3 (일본판)
Takahashi Meijin no Bouken-jima IV (Japan)=타카하시 명인의 모험도 4
Takahashi Meijin no Bugutte Honey (Japan)=타카하시 명인의 BUG로 허니
Takeda Shingen (Japan)=다케다 신겐
Takeda Shingen 2 (Japan)=타케다 신겐 2 (일본판)
Takeshi no Chousenjou (Japan) (Virtual Console)=타케시의 도전장 (일본판)(버추얼 콘솔)
Takeshi no Chousenjou (Japan)=타케시의 도전장
Takeshi no Sengoku Fuuunji (Japan) (Beta)=타케시의 전국풍운아 (일본판)(베타)
Takeshi no Sengoku Fuuunji (Japan)=타케시의 전국풍운아
Tale, The - Elrond no Eiyuu (Japan) (Beta)=테일 - 엘론도의 영웅 (일본판)(베타)
TaleSpin (Europe)=테일 스핀
TaleSpin (USA)=테일 스핀
Tamura Koushou Mahjong Seminar (Japan)=타무라 미츠아키의 마작 세미나
Tanigawa Kouji no Shougi Shinan II (Japan)=타니가와 코지의 장기 비법 2
Tanigawa Kouji no Shougi Shinan III (Japan)=타니가와 코지의 장기 비법 3
Tank (Asia) (En) (Asder) (Unl)=탱크 (아시아판)(영어)(해적판)
Tank (Asia) (En) (Caltron) (Unl)=탱크
Tanque (Spain) (Gluk Video) (Unl)=탱큐 (스페인판)(글럭 비디오)(해적판)
Tantei Jinguuji Saburou - Toki no Sugiyuku Mama ni (Japan)=탐정 진구지 사부로 - 시간 가는대로
Tantei Jinguuji Saburou - Yokohamakou Renzoku Satsujin Jiken (Japan) (Virtual Console)=탐정 진구지 사부로 - 요코하마 항 연속 살인사건 (일본판)(버추얼 콘솔)
Tantei Jinguuji Saburou - Yokohamakou Renzoku Satsujin Jiken (Japan)=탐정 진구지 사부로 - 요코하마 항 연속 살인사건
Tao (Japan)=타오 - 도
Target - Renegade (USA)=타겟 - 레니게이드
Taro's Quest (USA) (Proto)=타로스 퀘스트 (시험판)
Tasac (Asia) (Ja) (Unl)=타삭
Tashiro Masashi no Princess ga Ippai (Japan)=타시로 마사시의 프린세스가 잔뜩
Tatakae! Chou Robot Seimeitai Transformers - Convoy no Nazo (Japan) (Virtual Console)=싸워라! 초로봇생명체 트랜스포머 - 콘보이의 수수께끼 (일본판)(버추얼 콘솔)
Tatakae! Chou Robot Seimeitai Transformers - Convoy no Nazo (Japan)=싸워라! 초로봇생명체 트랜스포머 - 콘보이의 수수께끼
Tatakae!! Rahmen Man - Sakuretsu Choujin 102 Gei (Japan)=투장!! 라면맨 - 작열초인102예
Tatakai no Banka (Japan) (Rev 1)=투쟁의 만가 (일본판)(개정판 1)
Tatakai no Banka (Japan)=투쟁의 만가 (일본판)
Tecmo Baseball (USA)=테크모 베이스볼
Tecmo Bowl (Japan)=테크모 보울 (일본판)
Tecmo Bowl (USA) (Beta)=테크모 보울 (베타)
Tecmo Bowl (USA) (Rev 1)=테크모 보울
Tecmo Bowl (USA)=테크모 보울
Tecmo Bowl (World) (Rev 1) (Virtual Console, Switch Online)=테크모 보울 (세계판)(개정판 1)
Tecmo Cup - Football Game (Europe)=테크모컵 - 풋볼 게임
Tecmo Cup - Football Game (Spain)=테크모컵 - 풋볼 게임 (스페인판)
Tecmo Cup - Soccer Game (USA)=테크모컵 - 사커 게임
Tecmo NBA Basketball (USA) (NES-BK) (Rev 1)=테크모 NBA 바스켓 볼
Tecmo NBA Basketball (USA) (NES-BK)=테크모 NBA 바스켓 볼
Tecmo NBA Basketball (USA) (NES-N7)=테크모 NBA 바스켓 볼
Tecmo Super Bowl (Japan)=테크모 슈퍼 볼 (일본판)
Tecmo Super Bowl (USA) (Beta)=테크모 슈퍼 볼 (베타)
Tecmo Super Bowl (USA)=테크모 슈퍼 볼
Tecmo World Cup Soccer (Europe)=테크모 월드 컵 사커
Tecmo World Cup Soccer (Japan)=테크모 월드 컵 사커 (일본판)
Tecmo World Wrestling (Europe)=테크모 월드 레슬링
Tecmo World Wrestling (USA)=테크모 월드 레슬링
Teenage Mutant Hero Turtles (Europe) (Virtual Console)=돌연변이 닌자 거북이 (유럽판)(버추얼 콘솔)
Teenage Mutant Hero Turtles (Europe)=돌연변이 닌자 거북이
Teenage Mutant Hero Turtles - Tournament Fighters (Europe)=돌연변이 닌자 거북이 - 토너먼트 파이터
Teenage Mutant Hero Turtles II - The Arcade Game (Europe)=돌연변이 닌자 거북이 2 - 아케이드 게임
Teenage Mutant Ninja Turtles (Italy)=돌연변이 닌자 거북이 (이탈리아판)
Teenage Mutant Ninja Turtles (Japan)=돌연변이 닌자 거북이 (일본판)
Teenage Mutant Ninja Turtles (USA) (Beta)=돌연변이 닌자 거북이 (베타)
Teenage Mutant Ninja Turtles (USA) (Virtual Console)=돌연변이 닌자 거북이 (버추얼 콘솔)
Teenage Mutant Ninja Turtles (USA)=돌연변이 닌자 거북이
Teenage Mutant Ninja Turtles - Tournament Fighters (USA)=돌연변이 닌자 거북이 - 토너먼트 파이터
Teenage Mutant Ninja Turtles 2 - The Manhattan Project (Japan)=돌연변이 닌자 거북이 2 - 맨하탄 프로젝트 (일본판)
Teenage Mutant Ninja Turtles II - The Arcade Game (Australia)=돌연변이 닌자 거북이 2 - 아케이드 게임 (호주판)
Teenage Mutant Ninja Turtles II - The Arcade Game (USA) (Sample)=돌연변이 닌자 거북이 2 - 아케이드 게임 (샘플)
Teenage Mutant Ninja Turtles II - The Arcade Game (USA)=돌연변이 닌자 거북이 2 - 아케이드 게임
Teenage Mutant Ninja Turtles III - The Manhattan Project (USA)=돌연변이 닌자 거북이 3 - 맨하탄 프로젝트
Tenchi o Kurau (Japan) (Rev A)=천지를 먹다 (일본판)(개정판 A)
Tenchi o Kurau (Japan)=천지를 먹다 (일본판)
Tenchi o Kurau II - Shokatsu Koumei Den (Japan) (Rev A)=천지를 먹다 2 - 제갈공명전
Tenchi o Kurau II - Shokatsu Koumei Den (Japan)=천지를 먹다 2 - 제갈공명전 (일본판)
Tenka no Goikenban - Mito Koumon (Japan)=수호 황문
Tenkaichi Bushi - Keru Naguuru (Japan) (Namcot Collection)=천하제일 무사 - 차고 때리고 (일본판)
Tenkaichi Bushi - Keru Naguuru (Japan)=천하제일 무사 - 차고 때리고
Tennis (Europe)=테니스
Tennis (Japan, USA) (GameCube Edition)=테니스 (게임큐브 버전)
Tennis (Japan, USA)=테니스
Terao no Dosukoi Oozumou (Japan)=테라오의 도스코이 대스모
Terminator 2 (Japan)=터미네이터 2 (일본판)
Terminator 2 - Judgment Day (Europe)=터미네이터 2 - 심판의 날
Terminator 2 - Judgment Day (USA) (Beta)=터미네이터 2 - 심판의 날 (베타)
Terminator 2 - Judgment Day (USA)=터미네이터 2 - 심판의 날
Terminator, The (USA, Europe)=터미네이터
Terra Cresta (Japan)=독수리 오형제 / 테라 크레스타 (일본판)
Terra Cresta (USA)=독수리 오형제 / 테라 크레스타
Tetrastar - The Fighter (Japan)=테트라스타 - 파이터
Tetris (Bulletproof) (Japan) (Rev 1)=테트리스 (블렛프루프)(일본판)(개정판 1)
Tetris (Bulletproof) (Japan) (Rev 2)=테트리스
Tetris (Bulletproof) (Japan)=테트리스 (블렛프루프)(일본판)
Tetris (Europe)=테트리스
Tetris (USA) (Tengen) (Unl)=테트리스
Tetris (USA)=테트리스
Tetris 2 (Europe)=테트리스 2
Tetris 2 (USA)=테트리스 2
Tetris 2 + Bombliss (Japan) (Rev 1)=테트리스 2 + 봄브리스
Tetris 2 + Bombliss (Japan)=테트리스 2 + 봄브리스 (일본판)
Tetris Flash (Japan)=테트리스 플래시 (일본판)
Tetsudou Ou - Famicom Boardgame (Japan)=철도왕 - 패미콤 보드게임
Tetsuwan Atom (Japan)=철완 아톰
Thexder (Japan)=테그져
Thomas the Tank Engine & Friends (USA) (Proto)=토마스와 친구들
Three Stooges, The (USA) (Beta) (1989-02-23)=바보 삼총사 (베타)
Three Stooges, The (USA)=바보 삼총사
Thunder & Lightning (USA)=썬더 & 라이트닝
Thunder Warrior (Asia) (Ja) (Unl)=썬더 워리어
Thunderbirds (Japan)=썬더버드 (일본판)
Thunderbirds (USA)=썬더버드
Thundercade (USA)=썬더케이드
Tiger-Heli (Europe) (Rev 1)=타이거-헬리
Tiger-Heli (Europe)=타이거-헬리 (유럽판)
Tiger-Heli (Japan)=타이거-헬리 (일본판)
Tiger-Heli (USA)=타이거-헬리
Tiles of Fate (USA) (Unl)=타일즈 오브 페이트
Time Diver - Avenger (Asia) (En) (Unl)=타임 다이버 - 어벤져 (아시아판)(영어)(해적판)
Time Diver - Eon Man (USA) (Proto)=타임 다이버 - 이온맨
Time Lord (Europe)=타임 로드
Time Lord (USA)=타임 로드
Time Zone (Japan)=타임 존
Times of Lore (Japan)=타임즈 오브 로어 (일본판)
Times of Lore (USA)=타임즈 오브 로어
Tiny Toon Adventures (Europe)=타이니 툰 어드벤처
Tiny Toon Adventures (Japan)=타이니 툰 어드벤처 (일본판)
Tiny Toon Adventures (USA)=타이니 툰 어드벤처
Tiny Toon Adventures 2 - Montana Land e Youkoso (Japan)=타이니 툰 어드벤처 2 - 몬태나 랜드에 어서 오세요 (일본판)
Tiny Toon Adventures 2 - Trouble in Wackyland (Europe)=타이니 툰 어드벤처 2 - 트러블 인 와키랜드
Tiny Toon Adventures 2 - Trouble in Wackyland (USA)=타이니 툰 어드벤처 2 - 트러블 인 와키랜드
Tiny Toon Adventures Cartoon Workshop (Europe)=타이니 툰 어드벤처 카툰 워크샵
Tiny Toon Adventures Cartoon Workshop (USA)=타이니 툰 어드벤처 카툰 워크샵
Titan (Japan)=타이탄
Titan Warriors (USA) (Proto)=타이탄 워리어즈
TM Network - Live in Power Bowl (Japan)=TM 네트워크 - 라이브 인 파워 보울
To the Earth (Europe)=투 더 어스
To the Earth (USA)=투 더 어스
Toki (USA) (Beta)=주주전설 / 토키 (베타)
Toki (USA)=주주전설 / 토키
Toki no Tabibito - Time Stranger (Japan)=시공의 여행자
Tokkyuu Shirei Solbrain (Japan)=특구지령 소울 브레인 (일본판)
Tokoro-san no Mamoru mo Semeru mo (Japan)=토코로 씨의 지키는 것도 쳐들어가는 것도
Tom & Jerry (Japan)=톰과 제리 (일본판)
Tom & Jerry - The Ultimate Game of Cat and Mouse! (Europe)=톰과 제리 - 얼티메이트 게임 오브 캣 앤 마우스
Tom & Jerry - The Ultimate Game of Cat and Mouse! (USA)=톰과 제리 - 얼티메이트 게임 오브 캣 앤 마우스
Tom Sawyer no Bouken (Japan)=톰 소여의 모험 (일본판)
Tombs & Treasure (USA)=툼 & 트래져
Tommy T'S Sound Editor (USA) (Proto) (Program)=토미 T의 사운드 에디터
Toobin' (Korea) (Supercom) (Unl)=투빈 (한국판)(해적판)
Toobin' (USA) (Unl)=투빈
Top Gun (Europe)=탑건
Top Gun (Japan)=탑건 (일본판)
Top Gun (USA) (Rev 1)=탑건 (개정판 1)
Top Gun (USA)=탑건
Top Gun - Dual Fighters (Japan)=탑건 - 듀얼 파이터즈 (일본판)
Top Gun - The Second Mission (Europe)=탑 건 - 세컨드 미션
Top Gun - The Second Mission (USA)=탑 건 - 세컨드 미션
Top Rider (Japan)=탑 라이더
Top Striker (Japan)=탑 스트라이커
Total Funpak (Australia) (Unl)=토탈 펀팩
Total Recall (Europe)=토탈 리콜
Total Recall (USA)=토탈 리콜
Totally Rad (Europe)=토탈리 래드
Totally Rad (USA)=토탈리 래드
Totsuzen! Macchoman (Japan) (Beta)=돌연! 마초맨 (일본판)(베타)
Totsuzen! Macchoman (Japan)=돌연! 마초맨 (일본판)
Touchdown Fever (USA)=터치다운 피버
Touhou Kenbun Roku (Japan)=동방견문록
Toukon Club (Japan)=투혼 클럽
Toukyou Pachi-Slot Adventure (Japan) (Rev 1)=도쿄 파치슬로 어드벤처
Toukyou Pachi-Slot Adventure (Japan)=도쿄 파치슬로 어드벤처 (일본판)
Tower of Radia (USA) (Proto)=타워 오브 라디아 (시험판)
Town & Country Surf Designs - Thrilla's Surfari (USA)=타운 & 컨트리 서프 디자인 - 드릴라의 서파리
Town & Country Surf Designs - Wood & Water Rage (USA)=타운 & 컨트리 서프 디자인 - 우드 & 워터 레이지
Toxic Crusaders (USA)=톡식 크루세이더
Track & Field (USA)=트랙 & 필드
Track & Field II (Europe)=트랙 & 필드 2
Track & Field II (USA) (Rev A)=트랙 & 필드 2 (개정판 A)
Track & Field II (USA)=트랙 & 필드 2
Track & Field in Barcelona (Europe)=트랙 & 필드 바르셀로나
Treasure Master (USA)=트래져 마스터
Triathron, The (Japan)=트라이 애슬론
Trog! (Europe)=트로그
Trog! (USA)=트로그
Trojan (Europe)=투쟁의 만가 / 트로젠
Trojan (USA)=투쟁의 만가 / 트로젠
Trolls in Crazyland, The (Europe)=트롤즈 온 크레이지 랜드
Trolls on Treasure Island (USA) (Unl)=트롤즈 온 트래져 아일랜드
Tsuppari Oozumou (Japan) (Virtual Console)=츠파리 대스모 (일본판)(버추얼 콘솔)
Tsuppari Oozumou (Japan)=츠파리 대스모
Tsuppari Wars (Japan)=츠파리 워즈
Tsuri Kichi Sanpei - Blue Marlin Hen (Japan)=낚시광 산페이 - 블루 마린 편
Tsuru Pika Hagemaru - Mezase! Tsuru Seko no Akashi (Japan)=으랏차차 짠돌이 - 노려라! 구두쇠의 증
Tu Ji (Asia) (Unl)=투지 (아시아판)(해적판)
Turbo Racing (Europe)=터보 레이싱
Twin Cobra (USA)=트윈 코브라 / 구극 타이거
Twin Eagle (Asia) (Ja) (PAL) (Unl)=트윈 이글 (아시아판)(일본어)(PAL)(해적판)
Twin Eagle (Japan)=트윈 이글 (일본판)
Twin Eagle (USA)=트윈 이글
TwinBee (Japan)=트윈비
TwinBee 3 - Poko Poko Daimaou (Japan) (Sample)=트윈비 3 - 포코포코 대마왕 (일본판)(샘플)
TwinBee 3 - Poko Poko Daimaou (Japan)=트윈비 3 - 포코포코 대마왕
U-Force Power Games (USA) (Proto 1)=유포스 파워 게임즈
U-Force Power Games (USA) (Proto 2) [b]=유포스 파워 게임즈 (시험판 2)
U-Force Test (USA) (Test Program)=유포스 테스트
U.S. Championship V'Ball (Japan) (Sample)=U.S. 챔피언쉽 비치발리볼 (일본판)(샘플)
U.S. Championship V'Ball (Japan)=U.S. 챔피언쉽 비치발리볼 (일본판)
Uchuu Keibitai SDF (Japan)=우주 경비대 SDF
Uchuusen Cosmo Carrier (Japan)=우주선 - 코스모 케리어
Ufouria - The Saga (Europe) (Beta)=유포리아 - 더 사가 (유럽판)(베타)
Ufouria - The Saga (Europe)=유포리아 - 더 사가
Ufouria - The Saga (USA, Europe) (Wii U Virtual Console)=유포리아 - 더 사가 (미국,유럽판)(Wii U 버추얼 콘솔)
Ufouria - The Saga (USA, Europe) (Wii Virtual Console)=유포리아 - 더 사가 (미국,유럽판)(Wii 버추얼 콘솔)
Ultima - Exodus (USA)=울티마 - 엑소더스
Ultima - Kyoufu no Exodus (Japan)=울티마 - 공포의 엑소더스 (일본판)
Ultima - Quest of the Avatar (USA)=울티마 - 아마타의 길
Ultima - Seija e no Michi (Japan)=울티마 - 성자로의 길 (일본판)
Ultima - Warriors of Destiny (USA)=울티마 - 운명의 전사
Ultimate Air Combat (Europe) (En,Fr,De) (Beta)=얼티메이트 에어 컴뱃 (유럽판)(베타)
Ultimate Air Combat (Europe) (En,Fr,De)=얼티메이트 에어 컴뱃
Ultimate Air Combat (USA)=얼티메이트 에어 컴뱃
Ultimate Basketball (USA)=얼티메이트 베스킷볼
Ultimate League Soccer (Europe) (Unl)=얼티메이트 리그 싸커
Ultimate League Soccer (USA) (Unl)=얼티메이트 리그 싸커 (해적판)
Ultimate Stuntman, The (Asia) (En) (Unl)=얼티메이트 스턴트맨 (아시아판)(영어)(해적판)
Ultimate Stuntman, The (USA) (Unl)=얼티메이트 스턴트맨
Ultraman Club - Kaijuu Daikessen!! (Japan)=울트라맨 클럽 - 괴수 대결전!!
Ultraman Club 2 - Kaettekita Ultraman Club (Japan)=울트라맨 클럽 2 - 돌아온 울트라맨 클럽
Ultraman Club 3 - Matamata Shutsugeki!! Ultra Kyoudai (Japan)=울트라맨 클럽 3 - 또 다시 출격 울트라 형제
Uncanny X-Men, The (USA)=초능력 X-맨
Uncharted Waters (USA)=언차티드 워터 / 대항해시대
Uninvited (USA)=불청객
Universe Soldiers, The (Asia) (En) (Unl)=유니버설 솔져
Untouchables, The (Japan)=언터처블 (일본판)
Untouchables, The (USA) (Rev 1)=언터처블 (개정판 1)
Untouchables, The (USA) (Rev 2)=언터처블
Untouchables, The (USA)=언터처블
Urban Champion (World)=어반 챔피온
Urusei Yatsura - Lum no Wedding Bell (Japan) (Beta)=시끄러운 녀석들 - 라무의 웨딩 벨 (일본판)(베타)
Urusei Yatsura - Lum no Wedding Bell (Japan)=시끄러운 녀석들 - 라무의 웨딩 벨
USA Ice Hockey in FC (Japan)=미국 아이스 하키 (일본판)
Ushio to Tora - Shinen no Taiyou (Japan)=우시오와 토라 - 심연의 대요괴
Utsurun Desu - Kawauso Hawaii e Iku (Japan)=전염됩니다 - 수달 하와이에 가다
UWC (USA) (Proto)=UWC
Valkyrie no Bouken - Toki no Kagi Densetsu (Japan) (Namcot Collection)=왈큐레의 모험 - 시간의 열쇠 전설 (일본판)
Valkyrie no Bouken - Toki no Kagi Densetsu (Japan) (Virtual Console)=왈큐레의 모험 - 시간의 열쇠 전설 (일본판)(버추얼 콘솔)
Valkyrie no Bouken - Toki no Kagi Densetsu (Japan)=왈큐레의 모험 - 시간의 열쇠 전설
Vegas Connection - Casino kara Ai o Komete (Japan)=베가스 커넥션 - 카지노로부터 사랑을 담아
Vegas Dream (USA)=베가스 드림
Venice Beach Volleyball (Asia) (Ja) (Idea-Tek) (Unl)=베니스 비치 발리볼 (아시아판)(일본어)(해적판)
Venice Beach Volleyball (Asia) (Ja) (Super Mega) (Unl)=베니스 비치 발리볼 (아시아판)(일본어)(해적판)
Venice Beach Volleyball (USA) (Beta) (Unl)=베니스 비치 발리볼 (베타)(해적판)
Venice Beach Volleyball (USA) (Unl)=베니스 비치 발리볼
Venus Senki - Back the City (Japan)=비너스 전기
Vice - Project Doom (USA)=바이스 - 프로젝트 둠
Videomation (USA)=비디오메이션
Vindicators (USA) (Unl)=빈디케이터
Virus (USA) (Beta) (1989-xx-xx)=바이러스 (베타)(1989-xx-xx)
Virus (USA) (Beta) (1990-02-02)=바이러스 (베타)(1990-02-02)
Virus (USA) (Beta) (1990-03-xx)=바이러스 (베타)
Viva! Las Vegas (Japan)=비바! 라스 베가스 (일본판)
Volguard II (Japan)=고 기동전투 메카 볼가드 2
Volley Ball (Spain) (Gluk Video) (Unl)=배구 (스페인판)(글럭 비디오)(해적판)
Volleyball (USA, Europe) (Virtual Console)=발리볼 (미국,유럽판)(버추얼 콘솔)
Volleyball (USA, Europe)=발리볼
Wacky Races (USA)=와키 레이스
Wagyan Land (Japan) (Namcot Collection)=와간 랜드 (일본판)
Wagyan Land (Japan)=와간 랜드
Wagyan Land 2 (Japan) (Virtual Console)=와간 랜드 2 (일본판)(버추얼 콘솔)
Wagyan Land 2 (Japan)=와간 랜드 2
Wagyan Land 3 (Japan)=와간 랜드 3
Wai Wai World 2 - SOS!! Paseri Jou (Japan) (Virtual Console)=와이 와이 월드 2 - SOS!! 파세리 성 (일본판)(버추얼 콘솔)
Wai Wai World 2 - SOS!! Paseri Jou (Japan)=와이 와이 월드 2 - SOS!! 파세리 성
Wai Xing Zhan Shi (Asia) (Unl)=외성 전사
Wait and See! (Asia) (En) (Unl)=웨이트 엔드 씨
Wall Street Kid (USA)=월 스트리트 키드
Wally Bear and the No! Gang (USA) (Beta) (Unl)=월리 베어 엔드 더 노 갱 (베타)(해적판)
Wally Bear and the No! Gang (USA) (Unl)=월리 베어 엔드 더 노 갱
Wang Zi Fu Chou Ji (Asia) (Unl)=왕자복수기
Wanpaku Duck Yume Bouken (Japan) (Beta)=개구쟁이 오리 대 모험 (일본판)(베타)
Wanpaku Duck Yume Bouken (Japan)=개구쟁이 오리 대 모험 (일본판)
Wanpaku Kokkun no Gourmet World (Japan)=개구쟁이 요리사의 구루메 월드 (일본판)
War in the Gulf ~ Guerra del Golfo, La (Brazil, Spain) (CCE, Gluk Video) (Unl)=걸프전
War on Wheels (USA) (Proto)=워 온 휠즈
Wario no Mori (Japan) (En)=와리오의 숲 (일본판)(영어)
Wario's Woods (Europe)=와리오의 숲
Wario's Woods (USA)=와리오의 숲
Warpman (Japan) (Namcot Collection)=워프 맨 (일본판)
Warpman (Japan)=워프 맨
Wayne Gretzky Hockey (USA)=웨인 그레츠키 하키
Wayne's World (USA)=웨인즈 월드
WCW World Championship Wrestling (USA)=월드 챔피온쉽 레슬링
Wei Lai Xiao Zi (Asia) (Ja) (Unl)=미래소자 - 메탈 파이터 (아시아판)(일본어)(해적판)
Werewolf - The Last Warrior (Europe)=웨어울프 - 마지막 전사
Werewolf - The Last Warrior (USA)=웨어울프 - 마지막 전사
Western Kids (Japan)=웨스턴 키즈 (일본판)
Wheel of Fortune (USA) (Rev 1)=휠 오브 포츈
Wheel of Fortune (USA)=휠 오브 포츈
Wheel of Fortune - Family Edition (USA)=휠 오브 포츈 - 패밀리 에디션
Wheel of Fortune - Junior Edition (USA)=휠 오브 포츈 - 주니어 에디션
Wheel of Fortune Featuring Vanna White (USA)=휠 오브 포츈 - 반나 화이트 출연
Where in Time Is Carmen Sandiego (USA)=칼멘 센디에고는 어느 시간에 있나
Where's Waldo (USA)=웨어즈 월도
White Lion Densetsu - Pyramid no Kanata ni (Japan)=피라미드의 그분에게 (일본판)
Who Framed Roger Rabbit (USA)=누가 로져 래빗을 모함 했나
Whomp 'Em (USA)=서유기 월드 2
Widget (USA)=외계소년 위젯트
Wild Gunman (Japan, USA)=와일드 건맨
Wild Gunman (World) (Rev 1)=와일드 건맨
Willow (Europe)=윌로우
Willow (Japan)=윌로우 (일본판)
Willow (USA)=윌로우
Wily & Right no Rockboard - That's Paradise (Japan)=윌리와 라이트의 록보드 - 저것은 파라다이스
Win, Lose or Draw (USA)=승리, 패배 또는 비김
Winter Games (USA) (Rev 1)=동계 올림픽
Winter Games (USA)=동계 올림픽
Wit's (Japan)=윗츠
Wizardry - Knight of Diamonds - The Second Scenario (USA)=위저드리 - 다이아몬드의 기사
Wizardry - Proving Grounds of the Mad Overlord (Japan)=위저드리 - 미친 군주의 증명 (일본판)
Wizardry - Proving Grounds of the Mad Overlord (USA)=위저드리 - 미친 군주의 증명
Wizardry II - Llylgamyn no Isan (Japan)=위저드리 2 - 리르가민의 유산
Wizardry III - Diamond no Kishi (Japan)=위저드리 3 - 다이아몬드이 기사 (일본판)
Wizards & Warriors (Europe)=위저드 & 워리어즈
Wizards & Warriors (USA) (Rev 1)=위저드 & 워리어즈 (개정판 1)
Wizards & Warriors (USA)=위저드 & 워리어즈
Wizards & Warriors III - Kuros...Visions of Power (Europe)=위저드 & 워리어즈 3
Wizards & Warriors III - Kuros...Visions of Power (USA)=위저드 & 워리어즈 3
Wolverine (USA)=울버린
Wonderland Dizzy (Europe) (En,Fr,Es,Nl,Pt,Pl) (2015) (Unl)=이상한 나라의 디지
Wonderland Dizzy (Europe) (En,Fr,Es,Nl,Pt,Pl) (Proto) (1993-09-24) (Unl)=이상한 나라의 디지 (유럽판)(시험판)(1993-09-24)(해적판)
Woody Poko (Japan)=우디 포코
World Boxing (Japan)=월드 복싱
World Champ (Europe)=월드 챔프
World Champ (USA)=월드 챔프
World Class Track Meet (USA) (Rev 1)=월드 클래스 트랙 미트 (개정판 1)
World Class Track Meet (USA)=월드 클래스 트랙 미트
World Games (USA)=월드 게임즈
World Grand-Prix - Pole to Finish (Japan)=월드 그랑프리 - 폴 투 피니시 (일본판)
World of Card Games, The (Asia) (Ja) (Unl)=박극집금
World Super Tennis (Japan)=월드 슈퍼 테니스 (일본판)
Wrath of the Black Manta (Europe)=블랙 만타의 분노
Wrath of the Black Manta (USA) (Rev 1)=블랙 만타의 분노 (개정판 1)
Wrath of the Black Manta (USA)=블랙 만타의 분노
Wrecking Crew (World) (Virtual Console)=렉킹 크루 (세계판)(버추얼 콘솔)
Wrecking Crew (World)=렉킹 크루
Wurm - Journey to the Center of the Earth! (USA)=웜 - 저니 투 더 센터 오브 디 어스
WWF King of the Ring (Europe)=WWF 킹 오브 더 링
WWF King of the Ring (USA)=WWF 킹 오브 더 링
WWF Wrestlemania (Europe)=WWF 레슬매니아
WWF Wrestlemania (USA)=WWF 레슬매니아
WWF Wrestlemania - Steel Cage Challenge (Europe)=WWF 레슬매니아 - 스틸 케이스 챌린지
WWF Wrestlemania - Steel Cage Challenge (USA)=WWF 레슬매니아 - 스틸 케이스 챌린지
WWF Wrestlemania Challenge (Europe)=WWF 레슬매니아 첼린지
WWF Wrestlemania Challenge (Japan)=WWF 레슬매니아 첼린지 (일본판)
WWF Wrestlemania Challenge (USA)=WWF 레슬매니아 첼린지
Xenophobe (USA)=제노포브
Xevious (Europe)=제비우스
Xevious (Japan) (En) (Rev 1)=제비우스 (일본판)(영어)(개정판 1)
Xevious (Japan) (En)=제비우스 (일본판)(영어)
Xevious (World) (Namcot Collection, Namco Museum Archives Vol 1)=제비우스 (세계판)
Xevious - The Avenger (USA)=제비우스 - 어벤저
Xexyz (USA)=거북이의 보은 - 우라시마 전설
Xiao Ma Li (Asia) (Idea-Tek) (Unl)=소마리 (아시아판)(해적판)
Xiao Ma Li (Asia) (Nei-Hu) (Unl)=소마리
Xing He Zhan Shi (Asia) (Unl)=성하전사 (아시아판)(해적판)
Xing Ji Zheng Ba (Asia) (Unl)=성제쟁패 (아시아판)(해적판)
Xing Zhan Qing Yuan (Asia) (Unl)=성전정연 (아시아판)(해적판)
Xybots (USA) (Proto) (Unl)=자이보츠
Yamamura Misa Suspense Series - Kyoto Zai-Tech Satsujin Jiken (Japan)=야마무라 미사 서스펜스 - 교토 자이테크 살인사건
Yami no Shigotonin Kage (Japan)=어둠의 닌자 (일본판)
Yasuda Fire & Marine - Safety Rally (Japan)=세이프티 랠리
Yie Ar Kung-Fu (Japan) (Rev 1.2)=이 얼 쿵후 (일본판)(개정판 1.2)
Yie Ar Kung-Fu (Japan) (Rev 1.4)=이 얼 쿵후
Ying Lie Qun Xia Zhuan (Asia) (Unl)=영열군협전
Ying Xiong Yuan Yi Jing Chuan Qi (Asia) (Unl)=영웅원차경전의 (아시아판)(해적판)
Yo! Noid (USA) (Beta)=요! 노이드 (베타)
Yo! Noid (USA)=요! 노이드
Yoshi (USA)=요시
Yoshi no Cookie (Japan)=요시의 쿠키 (일본판)
Yoshi no Tamago (Japan)=요시의 알 (일본판)
Yoshi's Cookie (Europe) (Virtual Console)=요시의 쿠키 (유럽판)(버추얼 콘솔)
Yoshi's Cookie (Europe)=요시의 쿠키
Yoshi's Cookie (USA) (Virtual Console)=요시의 쿠키 (버추얼 콘솔)
Yoshi's Cookie (USA)=요시의 쿠키
You Ling Xing Dong (Asia) (Unl)=유령행동 (아시아판)(해적판)
Youkai Club (Japan)=요괴 클럽
Youkai Douchuuki (Japan) (Namcot Collection)=요괴 도중기 (일본판)
Youkai Douchuuki (Japan) (Virtual Console)=요괴 도중기 (일본판)(버추얼 콘솔)
Youkai Douchuuki (Japan)=요괴 도중기
Young Indiana Jones Chronicles, The (USA)=영 인디아나 존스 연대기
Yousei Monogatari - Rod Land (Japan)=요정전설 - 로드랜드 (일본판)
Ys (Japan)=이스
Ys II - Ancient Ys Vanished - The Final Chapter (Japan)=이스 2 - 배니시드 오멘 - 최종장
Ys III - Wanderers from Ys (Japan)=이스 3 - 원더러스 프롬 이스
Yume Penguin Monogatari (Japan)=꿈 펭귄 이야기
Zanac (USA)=자낙
Zelda II - The Adventure of Link (Europe) (Rev 1)=젤다 2 - 링크의 모험 (유럽판)(개정판 1)
Zelda II - The Adventure of Link (Europe) (Rev 2) (Virtual Console)=젤다 2 - 링크의 모험 (유럽판)(개정판 2)(버추얼 콘솔)
Zelda II - The Adventure of Link (Europe) (Rev 2)=젤다 2 - 링크의 모험
Zelda II - The Adventure of Link (Europe)=젤다 2 - 링크의 모험 (유럽판)
Zelda II - The Adventure of Link (USA) (Collector's Edition)=젤다 2 - 링크의 모험
Zelda II - The Adventure of Link (USA) (Virtual Console)=젤다 2 - 링크의 모험 (버추얼 콘솔)
Zelda II - The Adventure of Link (USA)=젤다 2 - 링크의 모험
Zelda no Densetsu 1 - The Hyrule Fantasy (Japan)=젤다의 전설 - 더 하이룰 판타지 (일본판)
Zen - Intergalactic Ninja (Europe)=젠 - 인터글릭 닌자
Zen - Intergalactic Ninja (USA)=젠 - 인터글릭 닌자
Zenbei Pro Basket (Japan)=전미 프로 바스켓 (일본판)
Zhan Guo Si Chuan Sheng (Asia) (C&E) (Unl)=전국사천성 (아시아판)(해적판)
Zhan Guo Si Chuan Sheng (Asia) (Nei-Hu) (Unl)=전국사천성 (아시아판)(해적판)
Zhen Ben Xi You Ji (Asia) (Ja) (Unl)=서유기
Zhi Li Xiao Zhuang Yuan (Asia) (Unl)=지력 소장원
Zhong Guo Mahjong (Asia) (Unl)=중국 마작 (아시아판)(해적판)
Zhong Guo Xiang Qi - Chinese Chese (Asia) (Ja) (Unl)=중국 장기 (아시아판)(일본어)(해적판)
Zhuang Qiu Chuan Shuo Hua Zhuang II - Ball Story (Asia) (Unl)=볼 스토리
Zippy Race (Japan)=지피 리이스
Zoda's Revenge - StarTropics II (USA)=스타트로픽스 2 - 조다의 복수
Zoda's Revenge - StarTropics II (USA, Europe) (Virtual Console)=스타트로픽스 2 - 조다의 복수 (미국,유럽판)(버추얼 콘솔)
Zoids - Chuuou Tairiku no Tatakai (Japan) (Rev 1)=조이드 - 주앙대륙의 싸움
Zoids - Chuuou Tairiku no Tatakai (Japan)=조이드 - 주앙대륙의 싸움 (일본판)
Zoids 2 - Zenebas no Gyakushuu (Japan)=조이드 2 - 제네바스의 역습
Zoids Mokushiroku (Japan)=조이드 묵시록
Zombie Hunter (Japan)=좀비 헌터
Zombie Nation (USA)=좀비 네이션
Zunou Senkan Galg (Japan) (En) (Beta)=두뇌 전함 갈 (일본판)(영어)(베타)
Zunou Senkan Galg (Japan) (En)=두뇌 전함 갈
