1943 Kai (Japan)=1943 카이
21 Emon - Mezase Hotel Ou!! (Japan)=21에몬 - 노려라 호텔왕!
Adventure Island (Japan)=고교 명인의 모험도 (일본판)
Aero Blasters (Japan)=에어로 블래스터즈- 트러블 스페셜티 레이드 유니트 (일본판)
Aero Blasters (USA)=에어로 블래스터즈- 트러블 스페셜티 레이드 유니트
After Burner II (Japan)=애프터 버너 2
Air Zonk (USA)=에어 종크
Alien Crush (Japan)=에일리언 크래쉬 (일본판)
Alien Crush (USA)=에일리언 크래쉬
All Star Power League (Japan)=올스타 파워리그 (일본판)
Andre Panza Kick Boxing (USA)=안드레 팬자 킥 복싱
Ankoku Densetsu (Japan)=암흑 전설 (일본판)
Aoi Blink (Japan)=푸른 망아지 브링크
Appare! Gateball (Japan)=장하다! 게이트 볼
Armed F (Japan)=포메이션 암드 F
Artist Tool (Japan)=아티스트 툴
Atomic Robo-Kid Special (Japan)=아토믹 로보 - 키드 스페셜
AV Poker - World Gambler (Japan) (Unl)=AV 포커 월드 갬블러
Ballistix (Japan)=볼리스틱스 (일본판)
Ballistix (USA)=볼리스틱스
Bari Bari Densetsu (Japan)=바리바리 전설
Barunba (Japan)=바룬바
Batman (Japan)=배트맨
Battle Lode Runner (Japan)=배틀 로드 런너
Battle Royale (USA)=배틀 로얄
Be Ball (Japan)=비 볼 (일본판)
Benkei Gaiden (Japan)=벤케이 외전 - 모래의 장
Bikkuriman World (Japan)=비쿠리맨 월드
Blazing Lazers (USA)=블레이징 레이져스
Blodia (Japan)=블로디아 (일본판)
Bloody Wolf (USA)=블러디 울프
Bodycon Quest II (Japan) (Unl)=보디 컨퀘스트 2
Bomber Man '93 (Japan)=봄버맨 93 (일본판)
Bomber Man '93 (USA)=봄버맨 93
Bomber Man '93 (USA, Europe) (Virtual Console)=봄버맨 93 (미국,유럽판)(버추얼 콘솔)
Bomber Man '93 - Special Version (Japan)=봄버맨 93 - 스페셜 버전
Bomber Man '94 (Japan)=봄버맨 94
Bomber Man (Japan)=봄버맨 (일본판)
Bomber Man (USA)=봄버맨
Bomber Man - Users Battle (Japan)=봄버맨
Bonk 3 - Bonk's Big Adventure (USA)=봉크 3 -봉크의 대모험
Bonk's Adventure (USA)=봉크의 모험
Bonk's Revenge (USA)=봉크의 복수
Bonk's Revenge (USA, Europe) (Virtual Console)=봉크의 복수 (미국,유럽판)(버추얼 콘솔)
Bouken Danshaku Don - The Lost Sunheart (Japan)=모험 남작 돈 - 태양가슴편
Boxyboy (USA)=박시 보이
Bravoman (USA)=초절륜인 브라보맨
Break In (Japan)=브레이크 인
Bubblegum Crash! - Knight Sabers 2034 (Japan)=버블검 크래시-나이트 세이버즈 2034
Bull Fight - Ring no Hasha (Japan)=불 파이트 - 링의 패자
Burning Angels (Japan)=버닝 엔젤스
Busou Keiji - Cyber Cross (Japan)=무장형사 사이버 크로스
Cadash (Japan)=카다쉬 (일본판)
Cadash (USA)=카다쉬
Champion Wrestler (Japan)=챔피언 레슬러
Champions Forever Boxing (USA)=챔피언 포에버 복싱
Chase H.Q. (USA)=체이스 H.Q.
Chew-Man-Fu (USA)=츄맨푸
Chibi Maruko-chan - Quiz de Piihyara (Japan)=치비 마루코짱 - 퀴즈 데 피햐라
Chikudenya Toubei - Kubikiri Yakata Yori (Japan)=축전옥 토우베이
China Warrior (USA)=쿵푸 - 차이나 워리어
Chouzetsurinjin Bravoman (Japan)=초절륜인 브라보맨 (일본판)
Circus Lido (Japan)=서커스 리도
City Hunter (Japan)=시티헌터
Columns (Japan)=컬럼스
Coryoon - Child of Dragon (Japan)=코륜 - 차일드 오브 드래곤
Cratermaze (USA)=미궁대작전
Cross Wiber - Cyber Combat Police (Japan)=크로스 위버 - 컴뱃 폴리스
Cyber Core (Japan)=사이버 코어 (일본판)
Cyber Core (USA)=사이버 코어
Cyber Dodge (Japan)=사이버 돗지볼
Cyber Knight (Japan)=사이버 나이트
Daichi-kun Crisis - Do Natural (Japan)=대지의 대위기 - 자연으로
Daisenpuu (Japan)=대선풍
Darius Alpha (Japan) (SG Enhanced)=다리우스 알파
Darius Plus (Japan) (SG Enhanced)=다리우스 플러스
Darkwing Duck (USA)=다크윙 덕
Davis Cup Tennis (USA)=데이비스컵 테니스
Dead Moon (USA)=데드문 - 달세계의 악몽
Dead Moon - Getsu Sekai no Akumu (Japan)=데드문 - 달세계의 악몽 (일본판)
Deep Blue (USA)=딥 블루 - 해저신화
Deep Blue - Kaitei Shinwa (Japan)=딥 블루 - 해저신화 (일본판)
Detana!! TwinBee (Japan)=나왔다!! 트윈비
Devil Crash - Naxat Pinball (Japan)=데빌 크래쉬 (일본판)
Devil's Crush (USA)=데빌 크러시
Die Hard (Japan)=다이하드
Digital Champ (Japan)=디지털 챔프 배틀 복싱
Don Doko Don! (Japan)=돈 도코 돈
Doraemon - Meikyuu Daisakusen (Japan)=도라에몽 - 미궁대작전 (일본판)
Doraemon - Nobita no Dorabian Night (Japan)=도라에몽 - 노비타의 도라비안 나이트
Double Dungeons (Japan)=더블 던젼스 (일본판)
Double Dungeons (USA)=더블 던젼스
Download (Japan)=다운로드
Dragon Egg! (Japan)=드래곤 에그
Dragon Saber (Japan)=드래곤 세이버
Dragon Spirit (Japan)=드래곤 스피릿 (일본판)
Dragon Spirit (USA)=드래곤 스피릿
Dragon's Curse (USA)=원더 보이 3 - 드래곤의 함정 / 모험도 3
Drop Off (USA)=드롭 오프
Drop Rock Hora Hora (Japan)=드롭 락 호라호라 (일본판)
Dungeon Explorer (Japan)=던전 익스플로러 (일본판)
Dungeon Explorer (USA)=던전 익스플로러
Dungeons & Dragons - Order of the Griffon (USA)=던전 앤 드래곤 - 오더 오브 그리폰
Energy (Japan)=에너지 맨
Eternal City - Toshi Tensou Keikaku (Japan)=도시전송계획 이터널시티
F-1 Dream (Japan)=F-1 드림
F-1 Pilot - You're King of Kings (Japan)=F-1 파일럿
F1 Circus '91 (Japan)=F1 서커스 91
F1 Circus '92 - The Speed of Sound (Japan)=F1 서커스 92 - 소리의 속도
F1 Circus (Japan)=F1 서커스
F1 Triple Battle (Japan)=F1 트리플 배틀
Falcon (USA)=팔콘
Fantasy Zone (Japan)=판타지 존 (일본판)
Fantasy Zone (USA)=판타지 존
Fighting Run (Japan)=파이팅 런
Final Blaster (Japan)=파이널 블래스터
Final Lap Twin (Japan)=파이널 랩 트윈 (일본판)
Final Lap Twin (USA)=파이널 랩 트윈
Final Match Tennis (Japan)=파이널 매치 테니스
Final Soldier (Japan) (En)=파이널 솔져
Final Soldier - Special Version (Japan) (En)=파이널 솔져 - 스페셜 버전
Fire Pro Wrestling - Combination Tag (Japan)=파이어 프로 레슬링 1 - 콤비네이션 태그
Fire Pro Wrestling 2 - 2nd Bout (Japan)=파이어 프로 레슬링 2 - 세컨트 바우트
Fire Pro Wrestling 3 - Legend Bout (Japan)=파이어 프로 레슬링 3 - 레전드 바우트
Formation Soccer - Human Cup '90 (Japan)=포메이션 사커 - 휴먼컵
Formation Soccer - On J League (Japan)=포메이션 사커 - J 리그
Fushigi no Yume no Alice (Japan)=불가사의한 꿈의 엘리스
Gai Flame (Japan)=가이 프레임
Gaia no Monshou (Japan)=가이아의 문장
Galaga '88 (Japan)=갤러그 88 (일본판)
Galaga '90 (USA)=갤러그 90
Ganbare! Golf Boys (Japan)=힘내라! 골프 보이즈
Gekisha Boy (Japan)=격사보이
Genji Tsuushin Agedama (Japan)=겐지통신 아게다마
Genpei Toumaden (Japan)=원평 토마전
Genpei Toumaden - Kan no Ni (Japan)=원평토마전 2 (일본판)
Ghost Manor (USA)=고스트 매너
Gokuraku! Chuuka Taisen (Japan)=극락! 중화대선
Gomola Speed (Japan)=고모라 스피드
Gradius (Japan)=그라디우스
Gunboat (USA)=건보트
Gunhed (Japan)=건헤드 - 블레이징 레이져스 (일본판)
Gunhed - Special Version (Japan)=건헤드 - 스페셜 버전
Hana Taaka Daka! (Japan)=의기양양
Hanii in the Sky (Japan)=하나이 인더 스카이
Hanii on the Road (Japan)=하나이 온더 로드
Hatris (Japan)=햇트리스
Heavy Unit (Japan)=헤비 유닛
Hisou Kihei X-Serd (Japan)=비장기병 가이자드
Hit the Ice - VHL - The Official Video Hockey League (USA)=히트 더 아이스 - 공식 비디오 하키 리그
Hit the Ice - VHL - The Video Hockey League (Japan)=히트 더 아이스 - 비디오 하키 리그 (일본판)
Honoo no Toukyuuji - Dodge Danpei (Japan)=피구왕 통키
Idol Hanafuda Fan Club (Japan) (Unl)=아이돌 화투 팬클럽
Image Fight (Japan)=이미지 파이트
Impossamole (USA)=임포싸 몰
J.J. & Jeff (USA)=카토짱과 켄짱
J.League Greatest Eleven (Japan)=J리그 그레이티스트 일레븐
Jack Nicklaus - Championship Golf (Japan)=잭 니클라우스 - 챔피언십 골프 (일본판)
Jack Nicklaus' Turbo Golf (USA)=잭 니클라우스 - 터보 골프
Jackie Chan (Japan)=성룡의 액션 쿵후 (일본판)
Jackie Chan's Action Kung Fu (USA)=성룡의 액션 쿵후
Jaseiken Necromancer (Japan) (Virtual Console)=사사성검 네크로맨서 (일본판)(버추얼 콘솔)
Jaseiken Necromancer (Japan)=사사성검 네크로맨서
Jigoku Meguri (Japan)=지옥순례
Jinmu Denshou (Japan)=신무전승 야차
Juuouki (Japan)=수왕기
Kaizou Choujin Shubibinman (Japan)=개조성인 슈비빅맨
Kaizou Choujin Shubibinman 2 - Aratanaru Teki (Japan)=개조성인 슈비빅맨 2 - 새로운적 (일본판)
Kato-chan Ken-chan (Japan)=카토짱 켄짱 (일본판)
Kattobi! Takuhai-kun (Japan)=캇트비! 택배-군
Keith Courage in Alpha Zones (USA)=마신 영웅전 와타루
KickBall (Japan)=킥볼
Kiki Kaikai (Japan)=기기괴계
King of Casino (Japan)=킹 오브 카지노 (일본판)
King of Casino (USA)=킹 오브 카지노
Klax (Japan)=클락스 (일본판)
Klax (USA)=클락스
Knight Rider Special (Japan)=나이트 라이더 스페셜
Kore ga Pro Yakyuu '89 (Japan)=이것이 프로야구 89
Kore ga Pro Yakyuu '90 (Japan)=이것이 프로야구 90
Kung Fu, The (Japan) (Virtual Console)=쿵후 (일본판)(버추얼 콘솔)
Kung Fu, The (Japan)=쿵후 (일본판)
Kyuukyoku Mahjong - Idol Graphics (Japan) (Unl)=궁극 마작 - 아이돌 그래픽스
Kyuukyoku Mahjong II (Japan) (Unl)=궁극 마작 2
Kyuukyoku Tiger (Japan)=구극 타이거
Lady Sword - Ryakudatsu Sareta 10-nin no Otome (Japan) (Unl)=레이디 소드
Legend of Hero Tonma (Japan)=영웅 톤마의 전설 (일본판)
Legend of Hero Tonma (USA)=영웅 톤마의 전설
Legendary Axe II (USA)=암흑전설
Legendary Axe, The (USA)=마경전설
Lode Runner - Lost Labyrinth (Japan)=로드 런너 - 잃어버린 미궁
Maerchen Maze (Japan)=메르헨 메이즈 - 동화미로
Magical Chase (Japan)=매지컬 체이스 (일본판)
Magical Chase (USA)=매지컬 체이스
Mahjong Gakuen - Touma Soushirou Toujou (Japan)=마작학원 - 아즈마종시로 등장
Mahjong Gakuen Mild - Touma Soushirou Toujou (Japan)=마작학원 MILD - 아즈마종시로 등장
Mahjong Gokuu Special (Japan)=마작학원 스페셜
Mahjong Haouden - Kaiser's Quest (Japan)=마작패왕전 - 카이져의 퀘스트
Mahjong Shikaku Retsuden - Mahjong Wars (Japan)=마작 자객 열전 - 마작 워즈
Maison Ikkoku (Japan)=메종일각 - 도레미하우스
Makai Hakkenden Shada (Japan)=마계 팔견전 샤다
Makai Prince Dorabocchan (Japan)=마계 프린드 도라보짱
Makyou Densetsu (Japan)=마경전설 (일본판)
Maniac Pro Wres - Asu e no Tatakai (Japan)=매니악 프로레슬링
Mashin Eiyuuden Wataru (Japan)=마신 영웅전 와타루 (일본판)
Mesopotamia (Japan)=메소포타미아 (일본판)
Metal Stoker (Japan)=메탈 스토커
Military Madness (USA)=밀리터리 매드니스
Mizubaku Daibouken (Japan)=미즈바쿠 대모험
Momotarou Densetsu Gaiden - Dai-1-shuu (Japan)=도태랑 전설 외전 제1집
Momotarou Densetsu II (Japan)=도태랑 전설 2
Momotarou Densetsu Turbo (Japan)=도태랑 전설 터보
Momotarou Katsugeki (Japan)=도태랑 활극
Monster Pro Wres (Japan)=몬스터 프로레슬링
Morita Shougi PC (Japan)=모리타 장기 PC
Moto Roader (Japan)=모토 로더 (일본판)
Moto Roader (USA)=모토 로더
Moto Roader II (Japan)=모토 로더 2
Mr. Heli no Daibouken (Japan)=미스터 헬리의 대모험
Narazumono Sentou Butai - Bloody Wolf (Japan)=깡패 전투부대 블러디 울프 (일본판)
Naxat Open (Japan)=나그자트 오픈
Naxat Stadium (Japan)=나그자트 스타디움
Nazo no Mascarade (Japan)=수수께끼의 가면
Necros no Yousai (Japan)=네크로스의 요새
Nectaris (Japan)=넥타리스 (일본판)
Nekketsu Koukou Dodgeball-bu - PC Bangai Hen (Japan)=열혈고교 피구부 - PC 번외편
Nekketsu Koukou Dodgeball-bu - PC Soccer Hen (Japan)=열혈고교 피구부 - PC 축구편
Neutopia (Japan)=뉴토피아 (일본판)
Neutopia (USA)=뉴토피아
Neutopia II (Japan)=뉴토피아 2 (일본판)
Neutopia II (USA)=뉴토피아 2
New Adventure Island (USA)=신모험도
NewZealand Story, The (Japan)=뉴질랜드 스토리
NHK Taiga Drama - Taiheiki (Japan)=NHK 대하드라마 태평기
Night Creatures (USA)=나이트 크리쳐스
Niko Niko Pun (Japan)=싱글 벙글 시간
Ninja Ryuukenden (Japan) (En,Ja,Zh)=닌자용검전
Ninja Spirit (USA)=닌자 스피리츠 / 최후의 인도
Ninja Warriors, The (Japan)=닌자 워리어즈
Obocchama-kun (Japan)=오보차마 군
Off the Wall (USA) (Proto)=오프 더 월
Operation Wolf (Japan)=오퍼레이션 울프
Ordyne (Japan)=오딘 (일본판)
Ordyne (USA)=오딘
Out Live (Japan)=아웃 라이브
Out Run (Japan)=아웃 런
Override (Japan)=오버라이드
P-47 - The Freedom Fighter (Japan)=P-47 - 프리덤 파이터
Pac-Land (Japan)=팩 랜드 (일본판)
Pac-Land (USA)=팩 랜드
Pachio-kun - Juuban Shoubu (Japan)=파치오군 - 10번 승부
Paranoia (Japan)=파라노이아 (일본판)
Parasol Stars - The Story of Bubble Bobble III (Japan)=파라솔 스타 - 버블 보블 3 이야기 (일본판)
Parasol Stars - The Story of Bubble Bobble III (USA)=파라솔 스타 - 버블 보블 3 이야기
Parodius Da! - Shinwa kara Owarai e (Japan)=파로디우스다 - 신화에서 웃음으로
PC Denjin - Punkic Cyborgs (Japan)=PC전인 - 펑킥 사이보그스 (일본판)
PC Genjin - Pithecanthropus Computerurus (Japan)=PC원인 (일본판)
PC Genjin 2 - Pithecanthropus Computerurus (Japan) (Virtual Console)=PC원인 2 - 봉크의 복수 (일본판)(버추얼 콘솔)
PC Genjin 2 - Pithecanthropus Computerurus (Japan)=PC원인 2 - 봉크의 복수 (일본판)
PC Genjin 3 - Pithecanthropus Computerurus (Japan) (Sample)=PC원인 3 - 봉크의 대모험 (일본판)(샘플)
PC Genjin 3 - Pithecanthropus Computerurus (Japan)=PC원인 3 - 봉크의 대모험 (일본판)
PC Pachi-Slot - Idol Gambler (Japan) (Unl)=PC 파치슬롯 - 아이돌 갬블러
Populous (Japan)=파퓰러스
Power Drift (Japan)=파워 드리프트
Power Eleven (Japan)=파워 일레븐
Power Gate (Japan)=파워 게이트
Power Golf (Japan)=파워 골프 (일본판)
Power Golf (USA)=파워 골프
Power League '93 (Japan)=파워 리그 93
Power League (Japan)=파워 리그 (일본판)
Power League 4 (Japan)=파워리그 4
Power League 5 (Japan)=파워리그 5
Power League II (Japan)=파워 리그 2
Power League III (Japan)=파워 리그 3
Power Sports (Japan)=파워 스포츠 (일본판)
Power Tennis (Japan)=파워 테니스
Pro Tennis - World Court (Japan)=프로 테니스 - 월드 코트 (일본판)
Pro Yakyuu World Stadium '91 (Japan)=프로 야구 월드 스타디움 91
Pro Yakyuu World Stadium (Japan)=프로 야구 월드 스타디움
Psycho Chaser (Japan)=사이코 체이서
Psychosis (USA)=사이코시스
Puzzle Boy (Japan)=퍼즐 보이
Puzznic (Japan)=퍼즈닉
Quiz Toukou Shashin (Japan) (Unl)=퀴즈 투고사진
R-Type (USA)=R - 타입
R-Type I (Japan)=R - 타입
R-Type II (Japan) (v1.1)=R - 타입 2
R-Type II (Japan)=R - 타입 2 (일본판)
Rabio Lepus Special (Japan)=라비오 레프스 스페셜
Racing Damashii (Japan)=레이싱 혼
Raiden (Japan)=라이덴 (일본판)
Raiden (USA)=라이덴
Rastan Saga II (Japan)=라스탄 사가 2
Rock-On (Japan)=락-온
Ryuukyuu (Japan)=류큐
S.C.I. - Special Criminal Investigation (Japan)=S.C.I. 스페셜 크리미럴 인베스티게이션
Sadakichi Seven - Hideyoshi no Ougon (Japan)=사다키치 세븐 - 히데요시의 황금
Saigo no Nindou - Ninja Spirit (Japan)=닌자 스피리츠 - 최후의 인도 (일본판)
Salamander (Japan)=사라만다
Samurai-Ghost (USA)=사무라이 고스트
Sekigahara (Japan)=세키가와라
Sengoku Mahjong (Japan)=전국 마작
Shanghai (Japan)=상하이
Shinobi (Japan)=시노비
Shiryou Sensen - War of the Dead (Japan)=사령전선 - 워 오브 더 데드
Shockman (USA)=쇼크맨
Shougi Shodan Icchokusen (Japan)=장기 초단 일직선
Shougi Shoshinsha Muyou (Japan)=장기 초심자 무용
SideArms (USA)=사이드암즈
SideArms - Hyper Dyne (Japan)=사이드암즈 - 하이퍼 다인 (일본판)
Silent Debuggers (Japan)=사일런트 디버거즈 (일본판)
Silent Debuggers (USA)=사일런트 디버거즈
Sindibad - Chitei no Daimakyuu (Japan)=신밧드 - 지저의 대마궁
Sinistron (USA)=시니스트론
Skweek (Japan)=스크위크
Soldier Blade (Japan)=솔져 블레이드 (일본판)
Soldier Blade (USA)=솔져 블레이드
Soldier Blade - Special Version (Japan)=솔쳐 블레이드 - 스페셜 버젼
Somer Assault (USA)=소머 어썰트
Son Son II (Japan)=손 손 2
Sonic Spike - World Championship Beach Volleyball (USA)=소닉 스파이크
Soukoban World (Japan)=창고번 월드 (일본판)
Space Harrier (Japan)=스페이스 해리어 (일본판)
Space Harrier (USA)=스페이스 해리어
Space Invaders - Fukkatsu no Hi (Japan)=스페이스 인베이더 - 부활의 날
Spin Pair (Japan)=스핀 페어
Spiral Wave (Japan)=스파이럴 웨이브
Splatterhouse (Japan) (En)=스플레터 하우스 (일본판)(영어)
Splatterhouse (USA)=스플레터 하우스
Stratego (Japan)=스트라테고
Street Fighter II' - Champion Edition (Japan)=스트리트 파이터 2 - 챔피언 에디션
Strip Fighter II (Japan) (Unl)=스트립 파이터 2
Super Metal Crusher (Japan)=슈퍼 메탈 크러셔
Super Momotarou Dentetsu (Japan)=슈퍼 도태랑 전철
Super Momotarou Dentetsu II (Japan)=슈퍼 도태랑 전철2
Super Star Soldier (Japan)=슈퍼 스타 솔져 (일본판)
Super Star Soldier (USA)=슈퍼 스타 솔져
Super Volley Ball (Japan)=슈퍼 발리볼 (일본판)
Super Volleyball (USA)=슈퍼 발리볼
Susanoou Densetsu (Japan)=스사노오 전설
Taito Chase H.Q. (Japan)=타이토 체이스 H.Q. (일본판)
Takahashi Meijin no Shin Bouken-jima (Japan)=타카하시 명인의 신 모험도 (일본판)
Takeda Shingen (Japan)=다케다 신겐
Takin' It to the Hoop (USA)=테이킨 잇 투더 후프
TaleSpin (USA)=테일 스핀
Tatsujin (Japan) (Beta)=타수진 (일본판)(베타)
Tatsujin (Japan)=타수진
Tatsunoko Fighter (Japan)=용의 아들파이터
Ten no Koe Bank (Japan)=텐노케 뱅크 카드
Tenseiryuu - Saint Dragon (Japan)=천성용 - 세인트 드래곤
Terra Cresta II - Mandoler no Gyakushuu (Japan)=독수리 오형제 2 / 테라 크레스타 2 - 만드라의 역습
Thunder Blade (Japan)=썬더 블레이드
Tiger Road (USA)=타이거 로드
Time Cruise (USA)=타임 크루즈
Time Cruise II (Japan)=타임 크루즈 2 (일본판)
Timeball (USA)=타임볼
Titan (Japan)=타이탄
Toilet Kids (Japan)=화장실 소년
Tora e no Michi (Japan)=호랑이의 길 / 타이거 로드 (일본판)
Tower of Druaga, The (Japan)=드루아가의 탑
Toy Shop Boys (Japan)=토이샵 보이즈
Tricky (Japan)=트릭키 (일본판)
Tricky Kick (USA)=트릭키 킥
Tsuppari Oozumou - Heisei Ban (Japan)=츠파리 대스모 - 헤이세이 판
Tsuru Teruhito no Jissen Kabushiki Bai Bai Game (Japan)=츠루 테루인의 실전 주식 배 바이 게임
Turrican (USA)=투리칸
TV Sports Basketball (Japan)=TV 스포츠 농구 (일본판)
TV Sports Basketball (USA)=TV 스포츠 농구
TV Sports Football (Japan)=TV 스포츠 축구 (일본판)
TV Sports Football (USA)=TV 스포츠 축구
TV Sports Hockey (Japan)=TV 스포츠 하키 (일본판)
TV Sports Hockey (USA)=TV 스포츠 하키
USA Pro Basketball (Japan)=USA 프로 바스켓볼 (일본판)
Valkyrie no Densetsu (Japan)=왈큐레의 전설
Veigues - Tactical Gladiator (Japan)=베이그스 - 택티컬 글래디에이터 (일본판)
Veigues - Tactical Gladiator (USA)=베이그스 - 택티컬 글래디에이터
Victory Run (USA)=빅토리 런
Victory Run - Eikou no 13,000km (Japan)=빅토리 런 (일본판)
Vigilante (Japan)=자경단 (일본판)
Vigilante (USA)=자경단
Violent Soldier (Japan)=바이오런트 솔져 (일본판)
Volfied (Japan)=볼피드 - 땅따먹기
W-Ring - The Double Rings (Japan)=W - 링 - 더블링스
Wai Wai Mahjong - Yukai na Janyuu-tachi (Japan)=와이 와이 마작
Wallaby!! - Usagi no Kuni no Kangaroo Race (Japan)=왈라비!! 토끼 나라의 캥거루 레이스
Winning Shot (Japan)=위닝 샷
Wonder Momo (Japan)=원더 모모
World Beach Volley (Japan)=월드 비치 발리볼 (일본판)
World Circuit (Japan)=월드 서킷
World Class Baseball (USA)=월드 클래스 베이스볼
World Class Baseball (USA, Europe) (Virtual Console)=월드 클래스 베이스볼 (미국,유럽판)(버추얼 콘솔)
World Court Tennis (USA)=월드 코트 테니스
World Jockey (Japan)=월드 자키
World Sports Competition (USA)=월드 스포츠 컴페티션
Xevious - Fardraut Saga (Japan)=제비우스 - 파드라우트 전설
Yo, Bro (USA)=요 브로
You-You Jinsei (Japan)=유유인생
Youkai Douchuuki (Japan) (Virtual Console)=요괴 도중기 (일본판)(버추얼 콘솔)
Youkai Douchuuki (Japan)=요괴 도중기
Zero4 Champ (Japan) (v1.5)=제로4 챔프
Zero4 Champ (Japan)=제로4 챔프 (일본판)
Zipang (Japan)=지팡
[BIOS] CD-ROM System (Japan) (v1.0)=[바이오스] CD-ROM 시스템 (일본판)(v1.0)
[BIOS] CD-ROM System (Japan) (v2.0)=[바이오스] CD-ROM 시스템 (일본판)(v2.0)
[BIOS] CD-ROM System (Japan) (v2.1)=[바이오스] CD-ROM 시스템 (일본판)(v2.1)
[BIOS] Games Express CD Card (Japan) (Blue Version)=[바이오스] 게임익스프레스 CD 카드 (일본판)(블루 버전)
[BIOS] Games Express CD Card (Japan) (Green Version)=[바이오스] 게임익스프레스 CD 카드
[BIOS] Super CD-ROM System (Japan) (v3.0)=[바이오스] 슈퍼 CD-ROM 시스템 (일본판)(v3.0)
[BIOS] TurboGrafx CD Super System Card (USA) (v3.0)=[바이오스] 터보그라픽스 CD 슈퍼 시스템 카드
[BIOS] TurboGrafx CD System Card (USA) (v2.0)=[바이오스] 터보그라픽스 CD 시스템 카드 (v2.0)
1941 - Counter Attack (Japan)=1941 - 카운터 어택
Aldynes - The Misson Code for Rage Crisis (Japan)=알디인즈 - 미션 코드 포 레이지 크라이시스
Battle Ace (Japan)=배틀 에이스
Daimakaimura (Japan)=대마계촌
Madou King Granzort (Japan)=마동왕 슈퍼 그랑죠
