Anchorz Field (Japan)=앵커즈 필드 (일본판)
Armored Unit (Japan)=아머드 유닛 (일본판)
Bakusou Dekotora Densetsu for WonderSwan (Japan)=폭주 데코트라 전설 원더스완 (일본판)
beat mania for WonderSwan (Japan)=비트매니아 원더스완 (일본판)
Buffers Evolution (Japan)=버퍼즈 에볼루션 (일본판)
Cardcaptor Sakura - Sakura to Fushigi na Clow Card (Japan)=카드캡터 사쿠라 - 사쿠라와 이상한 크로카드 (일본판)
Chaos Gear - Michibikareshi Mono (Japan)=카오스 기어 - 인도받는 자 (일본판)
Chocobo no Fushigi na Dungeon for WonderSwan (Japan) (Rev 1)=초코보의 신기한 던젼 원더스완 (일본판)(개정판 1)
Chocobo no Fushigi na Dungeon for WonderSwan (Japan) (Rev 2)=초코보의 신기한 던젼 원더스완 (일본판)(개정판 2)
Chocobo no Fushigi na Dungeon for WonderSwan (Japan) (Rev 3)=초코보의 신기한 던젼 원더스완 (일본판)(개정판 3)
Chou Aniki - Otoko no Tamafuda (Japan) (Rev 4)=초형귀 - 남자의혼찰 (일본판)(개정판 4)
Chou Denki Card Battle - Youfu Makai (Japan) (Rev 3)=초전기 카드배틀 - 요부 마계 (일본판)(개정판 3)
Clock Tower for WonderSwan (Japan) (Rev 1)=클락 타워 원더스완 (일본판)(개정판 1)
Crazy Climber (Japan)=크레이지 클라이머 (일본판)
D's Garage 21 Koubo Game - Tane o Maku Tori (Japan)=D의 게라지 21 공모 게임 - 씨를 뿌리는 새 (일본판)
Densha de Go! (Japan) (Rev 1)=전차로 고! (일본판)(개정판 1)
Densha de Go! 2 (Japan)=전차로 고! 2 (일본판)
Digimon - Ver. WonderSwan (Hong Kong)=디지몬 (홍콩판)
Digimon Adventure - Anode Tamer (Japan) (Rev 1)=디지몬 어드벤쳐 - 양극 태머 (일본판)(개정판 1)
Digimon Adventure - Anode Tamer (Japan)=디지몬 어드벤쳐 - 양극 태머 (일본판)
Digimon Adventure - Cathode Tamer (Japan)=디지몬 어드벤쳐 - 음극 태머 (일본판)
Digimon Adventure 02 - Tag Tamers (Japan) (Rev 1)=디지몬 어드벤쳐 2 - 태그 태머 (일본판)(개정판 1)
Digimon Adventure 02 - Tag Tamers (Japan)=디지몬 어드벤쳐 2 - 태그 태머 (일본판)
Digital Monster - Ver. WonderSwan (Japan) (Rev 1)=디지털 몬스터 원더스완 (일본판)(개정판 1)
Digital Partner (Japan)=디지털 파트너 (일본판)
Dokodemo Hamster (Japan)=어디서나 햄스터 (일본판)
Engacho! for WonderSwan (Japan)=인가초 원더스완 (일본판)
Fever - Sankyo Koushiki Pachinko Simulation for WonderSwan (Japan)=피버 - 산쿄 공식 파칭코 시뮬레이션 (일본판)
Final Lap 2000 (Japan)=파이널 랩 2000 (일본판)
Fire Pro Wrestling for WonderSwan (Japan) (Rev 5)=파이어 프로 레슬링 원더스완 (일본판)(개정판 5)
Fishing Freaks - Bass Rise for WonderSwan (Japan)=피싱 프릭스 - 배스라이즈 (일본판)
From TV Animation One Piece - Mezase Kaizoku Ou! (Japan)=TV 애니메이션 원피스 - 노려라 해적왕 (일본판)
Ganso Jajamaru-kun (Japan)=원조 자자마루군 (일본판)
Glocal Hexcite (Japan)=글로컬 헥사이트 (일본판)
Gomoku Narabe & Reversi - Touryuumon (Japan)=오목 & 리버시 등용문 (일본판)
Goraku Ou Tango! (Japan) (Rev 2)=오락왕 탱고! (일본판)(개정판 2)
GunPey (Japan)=건피 (일본판)
Hanafuda Shiyouyo (Japan)=화투 할게 (일본판)
Harobots (Japan) (Rev 1)=하로보츠 (일본판)(개정판 1)
Harobots (Japan)=하로보츠 (일본판)
Hunter X Hunter - Ishi o Tsugu Mono (Japan) (Rev 1)=헌터 X 헌터 - 의지를 잇는 자 (일본판)(개정판 1)
Hunter X Hunter - Ishi o Tsugu Mono (Japan) (Rev 2)=헌터 X 헌터 - 의지를 잇는 자 (일본판)(개정판 2)
Kakutou Ryouri Densetsu Bistro Recipe - Wonder Battle Hen (Japan)=격투 요리 전설 비스트로 레시피 - 원더 배틀편 (일본판)
Kaze no Klonoa - Moonlight Museum (Japan)=바람의 크로노아 - 문라이트 뮤지엄 (일본판)
Keiba Yosou Shien Soft - Yosou Shinkaron (Japan)=경마 예상 지원 소프트 - 예상진화론 (일본판)
Kiss Yori... - Seaside Serenade (Japan) (Rev 2)=키스부터…- 시사이드 세레나데 (일본판)(개정판 2)
Kosodate Quiz - Dokodemo My Angel (Japan)=육아 퀴즈 어디서나 - 마이 엔젤 (일본판)
Kyousouba Ikusei Simulation - Keiba (Japan) (Rev 1)=경주마 육성 시뮬레이션 - 케이바 (일본판)(개정판 1)
Langrisser Millennium WS - The Last Century (Japan) (Rev 1)=랑그릿사 밀레니엄 WS - 라스트 센츄리 (일본판)(개정판 1)
Last Stand (Japan)=라스트 스탠드 (일본판)
Lode Runner for WonderSwan (Japan)=로드 러너 원더스완 (일본판)
Macross - True Love Song (Japan)=마크로스 - 트루 러브 송 (일본판)
Magical Drop for WonderSwan (Japan)=매지컬 드롭 원더스완 (일본판)
Mahjong Touryuumon (Japan) (Rev 1)=마작 등용문 (일본판)(개정판 1)
Mahjong Touryuumon (Japan) (Rev 3)=마작 등용문 (일본판)(개정판 3)
Makaimura for WonderSwan (Japan)=마계촌 원더스완 (일본판)
Medarot Perfect Edition - Kabuto Version (Japan)=메다롯트 퍼펙트 에디션 - 카부토 버전 (일본판)
Medarot Perfect Edition - Kuwagata Version (Japan)=메다롯트 퍼펙트 에디션 - 쿠와가타 버전 (일본판)
Meitantei Conan - Majutsushi no Chousenjou! (Japan)=명탐정 코난 - 마술사의 도전장 (일본판)
Meitantei Conan - Nishi no Meitantei Saidai no Kiki! (Japan)=명탐정 코난 - 서쪽 명탐정 최대의 위기 (일본판)
Metakomi Theraphy - Nee Kiite! (Japan)=메타코미 테러피 - 자 들어봐! (일본판)
Mingle Magnet (Japan) (En,Ja) (Rev 1)=밍글 마그넷 (일본판)(영어)(개정판 1)
Mobile Suit Gundam MSVS (Japan)=기동전사 건담 MSVS (일본판)
MobileWonderGate (Japan) (Rev 1)=모바일원더게이트 (일본판)(개정판 1)
Moero!! Pro Yakyuu Rookies (Japan)=불타라!! 프로 야구 루키 (일본판)
Morita Shougi for WonderSwan (Japan)=모리타 장기 원더스완 (일본판)
Nazo Ou Pocket (Japan)=수수께끼 왕 포켓 (일본판)
Neon Genesis Evangelion - Shito Ikusei (Japan)=신세기 에반게리온 - 사도육성 (일본판)
Nice On (Japan) (Rev 1)=나이스 온 (일본판)(개정판 1)
Nihon Pro Mahjong Renmei Kounin - Tetsuman (Japan) (Rev 2)=일본 프로 마작 연맹 공인 - 철만 (일본판)(개정판 2)
Nobunaga no Yabou for WonderSwan (Japan)=노부나가의 야망 원더스완 (일본판)
Ou-chan no Oekaki Logic (Japan)=오짱의 오에카키 로직 (일본판)
Pocket Fighter (Japan)=포켓 파이터 (일본판)
Pro Mahjong Kiwame for WonderSwan (Japan) (Rev 1)=프로 마작 극 (일본판)(개정판 1)
Puyo Puyo Tsuu (Japan)=뿌요 뿌요 통 (일본판)
Puzzle Bobble (Japan)=퍼즐 보블 / 버스트 어 무브 (일본판)
Rainbow Islands - Putty's Party (Japan)=레인보우 아일랜드 - 퍼티 파티 (일본판)
Ring Infinity (Japan)=링 인피니티 (일본판)
Robot Works (Hong Kong) (En,Ja) (Rev 1)=로봇 워크 (홍콩판)(영어)(개정판 1)
Robot Works (Japan)=로봇 워크 (일본판)
Rockman & Forte - Mirai Kara no Chousensha (Japan)=록맨 & 포르테 - 미래로부터의 도전자 (일본판)
Sangokushi for WonderSwan (Japan)=삼국지 원더스완 (일본판)
Sangokushi II for WonderSwan (Japan)=삼국지 2 원더스완 (일본판)
SD Gundam - Emotional Jam (Japan) (Rev 2)=SD 건담 - 이모셔널 잼 (일본판)(개정판 2)
SD Gundam - Emotional Jam (Japan) (Rev 3)=SD 건담 - 이모셔널 잼 (일본판)(개정판 3)
SD Gundam G Generation - Gather Beat (Japan)=SD 건담 G 제너레이션 - 게더 비트 (일본판)
SD Gundam Gashapon Senki - Episode 1 (Japan) (16 MBit)=SD 건담 가샤폰 전기 - 에피소드 1 (일본판)
SD Gundam Gashapon Senki - Episode 1 (Japan) (8 MBit)=SD 건담 가샤폰 전기 - 에피소드 1 (일본판)
Senkaiden - TV Animation Senkaiden Houshin Engi Yori (Japan)=선계전 - TV 애니메이션 신계전 봉신연희 (일본판)
Sennou Millennium (Japan)=천년 밀레니엄 (일본판)
Shanghai Pocket (Japan)=상하이 포켓 (일본판)
Shin Nihon Pro Wrestling - Toukon Retsuden (Japan) (Rev 1)=신 일본 프로레슬링 - 투혼 열전 (일본판)(개정판 1)
Shougi Touryuumon (Japan)=장기 등용문 (일본판)
Side Pocket for WonderSwan (Japan)=사이드 포켓 (일본판)
Slither Link (Japan)=슬리더 링크 (일본판)
Soccer Yarou! - Challenge the World (Japan)=사커 하자! - 챌린지 더 월드 (일본판)
Sotsugyou for WonderSwan (Japan) (Rev 1)=졸업 (일본판)(개정판 1)
Space Invaders (Japan)=스페이스 인베이더 (일본판)
Super Robot Taisen Compact (Japan) (Rev 1)=슈퍼 로봇 대전 콤팩트 (일본판)(개정판 1)
Super Robot Taisen Compact (Japan) (Rev 2)=슈퍼 로봇 대전 콤팩트 (일본판)(개정판 2)
Super Robot Taisen Compact (Japan)=슈퍼 로봇 대전 콤팩트 (일본판)
Super Robot Taisen Compact 2 - Dai-1-bu - Chijou Gekidou Hen (Japan)=슈퍼 로봇 대전 콤팩트 2 - 제1부 - 지상 격동편 (일본판)
Super Robot Taisen Compact 2 - Dai-2-bu - Uchuu Gekishin Hen (Japan) (Rev 4)=슈퍼 로봇 대전 콤팩트 2 - 제2부 - 우주 격진편 (일본판)(개정판 4)
Super Robot Taisen Compact 2 - Dai-3-bu - Ginga Kessen Hen (Japan) (Rev 2)=슈퍼 로봇 대전 콤팩트 2 - 제3부 - 은하 결전편 (일본판)(개정판 2)
Taikyoku Igo - Heisei Kiin (Japan)=대국 바둑 - 헤이세이 킨 (일본판)
Tanjou Debut for WonderSwan (Japan) (Rev 1)=탄생 데뷰 (일본판)(개정판 1)
Tare Panda no GunPey (Japan)=타레팬더의 군페이 (일본판)
Tekken Card Challenge (Japan)=철권 카드 챌린지 (일본판)
Terrors (Japan)=테러 (일본판)
Tetsujin 28 Gou (Japan)=철인 28호 (일본판)
Time Bokan Series - Bokan Densetsu - Buta mo Odaterya Doronboo (Japan)=타임 보칸 시리즈 - 보칸전설 (일본판)
Tokyo Majin Gakuen - Fuju Houroku (Japan)=도쿄 마인 학원 - 부주봉록 (일본판)
Trump Collection - Bottom-Up Teki Trump Seikatsu (Japan) (Rev 1)=트럼프 컬랙션 - 보텀업 적 트럼프 생활 (일본판)(개정판 1)
Trump Collection 2 - Bottom-Up Teki Sekaiisshuu no Tabi (Japan) (Rev 1)=트럼프 컬랙션 2 - 보텀업 적 세계일주 여행 (일본판)(개정판 1)
Turntablist - DJ Battle (Japan)=턴테이블리스트 - DJ 배틀 (일본판)
Umizuri ni Ikou! (Japan)=바다낚시 가자! (일본판)
Uzumaki - Denshi Kaiki Hen (Japan) (Rev 4)=소용돌이 - 전시괴기편 (일본판)(개정판 4)
Uzumaki - Noroi Simulation (Japan)=소용돌이 - 저주 시뮬레이션 (일본판)
Vaitz Blade (Japan) (Rev 1)=바이츠 블레이드 (일본판)(개정판 1)
Wasabi Produce - Street Dancer (Japan)=와사비 프로듀스 - 스트리트 댄서 (일본판)
Wonder Stadium '99 (Japan)=원더 스타디움 99 (일본판)
Wonder Stadium (Japan)=원더 스타디움 (일본판)
WonderSwan Handy Sonar (Japan) (Rev 1)=원더스완 핸디 소나 (일본판)(개정판 1)
WonderSwan Handy Sonar (Japan) (Rev 2)=원더스완 핸디 소나 (일본판)(개정판 2)
WonderWitch (Japan) (FreyaOS 1.1.5) (Program)=원더위치 (일본판)(프로그램)
WonderWitch (Japan) (FreyaOS 1.2.0) (Program)=원더위치 (일본판)(프로그램)
[BIOS] WonderSwan Boot ROM (Japan) (En)=[바이오스] 원더스완 부트 롬 (일본판)(영어)
